,real_type,real_start,real_end,read_count,var_size
500_30_0,INVERSION,58,102,130,44
500_30_1,INVERSION,320,375,123,55
500_30_2,INVERSION,427,522,115,95
500_30_3,INVERSION,201,351,120,150
500_30_4,INVERSION,106,218,231,112
500_35_0,INVERSION,296,449,117,153
500_35_1,INVERSION,345,420,102,75
500_35_2,INVERSION,49,186,134,137
500_35_3,INVERSION,82,136,97,54
500_35_4,INVERSION,381,466,157,85
500_40_0,INVERSION,343,496,76,153
500_40_1,INVERSION,307,333,80,26
500_40_2,INVERSION,197,280,67,83
500_40_3,INVERSION,57,88,77,31
500_40_4,INVERSION,70,108,81,38
500_45_0,INVERSION,74,239,75,165
500_45_1,INVERSION,180,285,64,105
500_45_2,INVERSION,113,149,58,36
500_45_3,INVERSION,185,251,70,66
500_45_4,INVERSION,403,458,73,55
500_50_0,INVERSION,174,243,72,69
500_50_1,INVERSION,186,329,96,143
500_50_2,INVERSION,176,227,71,51
500_50_3,INVERSION,105,237,83,132
500_50_4,INVERSION,239,277,82,38
500_55_0,INVERSION,203,259,62,56
500_55_1,INVERSION,192,337,58,145
500_55_2,INVERSION,312,394,73,82
500_55_3,INVERSION,195,240,49,45
500_55_4,INVERSION,256,299,56,43
500_60_0,INVERSION,176,213,62,37
500_60_1,INVERSION,318,372,62,54
500_60_2,INVERSION,346,381,61,35
500_60_3,INVERSION,337,452,64,115
500_60_4,INVERSION,171,313,59,142
500_65_0,INVERSION,277,316,57,39
500_65_1,INVERSION,180,239,52,59
500_65_2,INVERSION,366,435,34,69
500_65_3,INVERSION,154,254,51,100
500_65_4,INVERSION,347,429,48,82
500_70_0,INVERSION,272,433,49,161
500_70_1,INVERSION,332,393,54,61
500_70_2,INVERSION,294,370,51,76
500_70_3,INVERSION,158,292,41,134
500_70_4,INVERSION,351,491,41,140
500_75_0,INVERSION,330,476,34,146
500_75_1,INVERSION,132,261,40,129
500_75_2,INVERSION,218,359,43,141
500_75_3,INVERSION,305,442,43,137
500_75_4,INVERSION,193,304,41,111
600_30_0,INVERSION,135,289,87,154
600_30_1,INVERSION,189,324,122,135
600_30_2,INVERSION,379,550,92,171
600_30_3,INVERSION,414,475,159,61
600_30_4,INVERSION,337,373,134,36
600_35_0,INVERSION,381,552,89,171
600_35_1,INVERSION,430,527,101,97
600_35_2,INVERSION,509,698,90,189
600_35_3,INVERSION,219,359,99,140
600_35_4,INVERSION,275,428,132,153
600_40_0,INVERSION,492,578,105,86
600_40_1,INVERSION,375,453,75,78
600_40_2,INVERSION,130,233,72,103
600_40_3,INVERSION,506,680,65,174
600_40_4,INVERSION,467,587,77,120
600_45_0,INVERSION,293,456,94,163
600_45_1,INVERSION,485,592,121,107
600_45_2,INVERSION,133,208,73,75
600_45_3,INVERSION,161,249,62,88
600_45_4,INVERSION,195,299,59,104
600_50_0,INVERSION,372,565,73,193
600_50_1,INVERSION,210,349,57,139
600_50_2,INVERSION,313,415,53,102
600_50_3,INVERSION,318,364,59,46
600_50_4,INVERSION,93,253,94,160
600_55_0,INVERSION,455,577,43,122
600_55_1,INVERSION,290,399,60,109
600_55_2,INVERSION,264,437,63,173
600_55_3,INVERSION,143,256,55,113
600_55_4,INVERSION,212,299,50,87
600_60_0,INVERSION,391,486,38,95
600_60_1,INVERSION,181,237,57,56
600_60_2,INVERSION,128,309,43,181
600_60_3,INVERSION,395,594,48,199
600_60_4,INVERSION,284,323,40,39
600_65_0,INVERSION,300,458,43,158
600_65_1,INVERSION,430,546,40,116
600_65_2,INVERSION,119,318,55,199
600_65_3,INVERSION,159,315,45,156
600_65_4,INVERSION,311,415,54,104
600_70_0,INVERSION,466,578,33,112
600_70_1,INVERSION,188,307,42,119
600_70_2,INVERSION,192,290,47,98
600_70_3,INVERSION,281,418,50,137
600_70_4,INVERSION,454,651,47,197
600_75_0,INVERSION,328,376,42,48
600_75_1,INVERSION,160,342,44,182
600_75_2,INVERSION,403,486,41,83
600_75_3,INVERSION,243,422,32,179
600_75_4,INVERSION,325,492,37,167
700_30_0,INVERSION,306,485,161,179
700_30_1,INVERSION,418,518,89,100
700_30_2,INVERSION,571,741,91,170
700_30_3,INVERSION,538,584,95,46
700_30_4,INVERSION,558,708,163,150
700_35_0,INVERSION,190,342,96,152
700_35_1,INVERSION,567,674,109,107
700_35_2,INVERSION,534,635,71,101
700_35_3,INVERSION,468,686,94,218
700_35_4,INVERSION,225,277,84,52
700_40_0,INVERSION,333,394,78,61
700_40_1,INVERSION,337,493,112,156
700_40_2,INVERSION,184,216,65,32
700_40_3,INVERSION,174,231,69,57
700_40_4,INVERSION,80,175,82,95
700_45_0,INVERSION,590,718,74,128
700_45_1,INVERSION,134,267,125,133
700_45_2,INVERSION,204,258,74,54
700_45_3,INVERSION,183,222,81,39
700_45_4,INVERSION,435,493,59,58
700_50_0,INVERSION,381,480,68,99
700_50_1,INVERSION,350,547,90,197
700_50_2,INVERSION,563,637,88,74
700_50_3,INVERSION,395,488,67,93
700_50_4,INVERSION,342,502,62,160
700_55_0,INVERSION,505,547,49,42
700_55_1,INVERSION,570,651,50,81
700_55_2,INVERSION,386,544,59,158
700_55_3,INVERSION,320,409,58,89
700_55_4,INVERSION,144,365,65,221
700_60_0,INVERSION,396,565,57,169
700_60_1,INVERSION,392,554,71,162
700_60_2,INVERSION,399,530,50,131
700_60_3,INVERSION,400,578,56,178
700_60_4,INVERSION,230,308,45,78
700_65_0,INVERSION,330,524,50,194
700_65_1,INVERSION,487,575,47,88
700_65_2,INVERSION,440,623,54,183
700_65_3,INVERSION,464,547,39,83
700_65_4,INVERSION,507,569,61,62
700_70_0,INVERSION,205,382,55,177
700_70_1,INVERSION,506,657,38,151
700_70_2,INVERSION,312,531,42,219
700_70_3,INVERSION,436,613,51,177
700_70_4,INVERSION,351,421,40,70
700_75_0,INVERSION,148,221,35,73
700_75_1,INVERSION,349,455,38,106
700_75_2,INVERSION,156,327,41,171
700_75_3,INVERSION,301,465,36,164
700_75_4,INVERSION,286,373,39,87
800_30_0,INVERSION,338,526,113,188
800_30_1,INVERSION,495,552,91,57
800_30_2,INVERSION,295,440,136,145
800_30_3,INVERSION,305,348,91,43
800_30_4,INVERSION,388,475,119,87
800_35_0,INVERSION,343,466,103,123
800_35_1,INVERSION,366,572,113,206
800_35_2,INVERSION,391,464,108,73
800_35_3,INVERSION,259,319,99,60
800_35_4,INVERSION,500,623,102,123
800_40_0,INVERSION,560,796,66,236
800_40_1,INVERSION,645,766,95,121
800_40_2,INVERSION,563,680,83,117
800_40_3,INVERSION,193,347,78,154
800_40_4,INVERSION,298,363,82,65
800_45_0,INVERSION,630,767,70,137
800_45_1,INVERSION,383,646,77,263
800_45_2,INVERSION,372,482,59,110
800_45_3,INVERSION,281,368,60,87
800_45_4,INVERSION,552,723,77,171
800_50_0,INVERSION,449,563,73,114
800_50_1,INVERSION,220,324,67,104
800_50_2,INVERSION,323,433,53,110
800_50_3,INVERSION,515,602,53,87
800_50_4,INVERSION,137,400,55,263
800_55_0,INVERSION,409,651,53,242
800_55_1,INVERSION,351,615,66,264
800_55_2,INVERSION,389,560,49,171
800_55_3,INVERSION,345,577,60,232
800_55_4,INVERSION,557,822,76,265
800_60_0,INVERSION,278,336,45,58
800_60_1,INVERSION,543,593,54,50
800_60_2,INVERSION,154,302,44,148
800_60_3,INVERSION,551,814,45,263
800_60_4,INVERSION,307,476,60,169
800_65_0,INVERSION,324,425,40,101
800_65_1,INVERSION,282,402,45,120
800_65_2,INVERSION,606,771,42,165
800_65_3,INVERSION,310,472,39,162
800_65_4,INVERSION,213,398,44,185
800_70_0,INVERSION,201,416,42,215
800_70_1,INVERSION,495,583,39,88
800_70_2,INVERSION,619,703,57,84
800_70_3,INVERSION,337,601,38,264
800_70_4,INVERSION,548,770,34,222
800_75_0,INVERSION,219,462,41,243
800_75_1,INVERSION,170,286,29,116
800_75_2,INVERSION,287,459,30,172
800_75_3,INVERSION,621,687,36,66
800_75_4,INVERSION,225,358,41,133
900_30_0,INVERSION,654,737,105,83
900_30_1,INVERSION,187,297,130,110
900_30_2,INVERSION,763,977,113,214
900_30_3,INVERSION,638,838,107,200
900_30_4,INVERSION,748,881,88,133
900_35_0,INVERSION,495,635,126,140
900_35_1,INVERSION,288,344,99,56
900_35_2,INVERSION,277,343,135,66
900_35_3,INVERSION,735,942,102,207
900_35_4,INVERSION,790,1030,111,240
900_40_0,INVERSION,429,542,66,113
900_40_1,INVERSION,762,912,100,150
900_40_2,INVERSION,297,557,80,260
900_40_3,INVERSION,478,657,86,179
900_40_4,INVERSION,251,522,99,271
900_45_0,INVERSION,603,674,70,71
900_45_1,INVERSION,410,585,69,175
900_45_2,INVERSION,451,526,95,75
900_45_3,INVERSION,297,393,53,96
900_45_4,INVERSION,302,376,77,74
900_50_0,INVERSION,179,376,73,197
900_50_1,INVERSION,705,808,66,103
900_50_2,INVERSION,332,519,64,187
900_50_3,INVERSION,584,809,75,225
900_50_4,INVERSION,650,774,84,124
900_55_0,INVERSION,629,840,68,211
900_55_1,INVERSION,650,818,64,168
900_55_2,INVERSION,375,592,46,217
900_55_3,INVERSION,770,1039,50,269
900_55_4,INVERSION,311,374,64,63
900_60_0,INVERSION,691,925,70,234
900_60_1,INVERSION,219,450,71,231
900_60_2,INVERSION,602,854,46,252
900_60_3,INVERSION,304,549,64,245
900_60_4,INVERSION,598,891,60,293
900_65_0,INVERSION,317,379,38,62
900_65_1,INVERSION,383,513,59,130
900_65_2,INVERSION,367,574,48,207
900_65_3,INVERSION,348,477,58,129
900_65_4,INVERSION,293,352,48,59
900_70_0,INVERSION,532,724,45,192
900_70_1,INVERSION,574,725,37,151
900_70_2,INVERSION,206,373,40,167
900_70_3,INVERSION,258,552,36,294
900_70_4,INVERSION,302,469,37,167
900_75_0,INVERSION,489,787,54,298
900_75_1,INVERSION,399,668,37,269
900_75_2,INVERSION,242,384,36,142
900_75_3,INVERSION,353,486,56,133
900_75_4,INVERSION,673,912,42,239
1000_30_0,INVERSION,406,638,95,232
1000_30_1,INVERSION,82,321,111,239
1000_30_2,INVERSION,124,240,174,116
1000_30_3,INVERSION,455,556,140,101
1000_30_4,INVERSION,611,885,98,274
1000_35_0,INVERSION,405,695,95,290
1000_35_1,INVERSION,504,638,126,134
1000_35_2,INVERSION,698,968,99,270
1000_35_3,INVERSION,700,913,151,213
1000_35_4,INVERSION,276,427,79,151
1000_40_0,INVERSION,876,1145,80,269
1000_40_1,INVERSION,668,833,117,165
1000_40_2,INVERSION,166,308,90,142
1000_40_3,INVERSION,265,362,107,97
1000_40_4,INVERSION,872,1046,83,174
1000_45_0,INVERSION,459,585,107,126
1000_45_1,INVERSION,736,911,101,175
1000_45_2,INVERSION,199,507,70,308
1000_45_3,INVERSION,740,834,63,94
1000_45_4,INVERSION,229,504,93,275
1000_50_0,INVERSION,169,377,63,208
1000_50_1,INVERSION,402,497,69,95
1000_50_2,INVERSION,792,1019,48,227
1000_50_3,INVERSION,366,674,52,308
1000_50_4,INVERSION,474,705,66,231
1000_55_0,INVERSION,226,526,44,300
1000_55_1,INVERSION,660,792,56,132
1000_55_2,INVERSION,725,849,48,124
1000_55_3,INVERSION,516,607,62,91
1000_55_4,INVERSION,259,345,62,86
1000_60_0,INVERSION,445,690,43,245
1000_60_1,INVERSION,454,618,64,164
1000_60_2,INVERSION,763,1008,58,245
1000_60_3,INVERSION,535,651,52,116
1000_60_4,INVERSION,316,567,49,251
1000_65_0,INVERSION,540,628,38,88
1000_65_1,INVERSION,563,737,37,174
1000_65_2,INVERSION,382,710,60,328
1000_65_3,INVERSION,255,383,42,128
1000_65_4,INVERSION,453,724,52,271
1000_70_0,INVERSION,567,804,56,237
1000_70_1,INVERSION,738,919,47,181
1000_70_2,INVERSION,379,692,37,313
1000_70_3,INVERSION,489,636,39,147
1000_70_4,INVERSION,445,608,50,163
1000_75_0,INVERSION,667,919,39,252
1000_75_1,INVERSION,701,820,30,119
1000_75_2,INVERSION,752,1047,32,295
1000_75_3,INVERSION,755,897,47,142
1000_75_4,INVERSION,551,683,44,132
1100_30_0,INVERSION,889,1236,100,347
1100_30_1,INVERSION,136,298,94,162
1100_30_2,INVERSION,762,924,125,162
1100_30_3,INVERSION,609,886,115,277
1100_30_4,INVERSION,892,1144,126,252
1100_35_0,INVERSION,343,498,119,155
1100_35_1,INVERSION,844,919,83,75
1100_35_2,INVERSION,879,1010,96,131
1100_35_3,INVERSION,288,573,122,285
1100_35_4,INVERSION,909,1020,96,111
1100_40_0,INVERSION,261,389,69,128
1100_40_1,INVERSION,861,932,89,71
1100_40_2,INVERSION,573,779,75,206
1100_40_3,INVERSION,131,488,90,357
1100_40_4,INVERSION,537,588,92,51
1100_45_0,INVERSION,300,350,71,50
1100_45_1,INVERSION,569,873,63,304
1100_45_2,INVERSION,652,780,79,128
1100_45_3,INVERSION,619,908,89,289
1100_45_4,INVERSION,651,759,87,108
1100_50_0,INVERSION,627,893,71,266
1100_50_1,INVERSION,492,796,55,304
1100_50_2,INVERSION,559,774,66,215
1100_50_3,INVERSION,795,1020,69,225
1100_50_4,INVERSION,608,727,55,119
1100_55_0,INVERSION,893,997,53,104
1100_55_1,INVERSION,386,466,57,80
1100_55_2,INVERSION,274,468,50,194
1100_55_3,INVERSION,881,1020,63,139
1100_55_4,INVERSION,401,533,46,132
1100_60_0,INVERSION,555,685,49,130
1100_60_1,INVERSION,428,723,56,295
1100_60_2,INVERSION,861,996,43,135
1100_60_3,INVERSION,275,488,45,213
1100_60_4,INVERSION,858,1092,54,234
1100_65_0,INVERSION,714,1007,39,293
1100_65_1,INVERSION,600,807,51,207
1100_65_2,INVERSION,841,1134,52,293
1100_65_3,INVERSION,430,540,36,110
1100_65_4,INVERSION,325,486,41,161
1100_70_0,INVERSION,590,701,32,111
1100_70_1,INVERSION,633,956,38,323
1100_70_2,INVERSION,411,655,38,244
1100_70_3,INVERSION,268,410,38,142
1100_70_4,INVERSION,611,735,41,124
1100_75_0,INVERSION,550,830,43,280
1100_75_1,INVERSION,635,777,48,142
1100_75_2,INVERSION,462,781,34,319
1100_75_3,INVERSION,365,483,31,118
1100_75_4,INVERSION,455,616,32,161
1200_30_0,INVERSION,669,911,113,242
1200_30_1,INVERSION,384,553,147,169
1200_30_2,INVERSION,1051,1107,99,56
1200_30_3,INVERSION,745,955,122,210
1200_30_4,INVERSION,660,911,89,251
1200_35_0,INVERSION,721,1087,121,366
1200_35_1,INVERSION,789,861,79,72
1200_35_2,INVERSION,713,781,88,68
1200_35_3,INVERSION,616,866,108,250
1200_35_4,INVERSION,738,883,117,145
1200_40_0,INVERSION,306,379,99,73
1200_40_1,INVERSION,877,1060,69,183
1200_40_2,INVERSION,864,1017,95,153
1200_40_3,INVERSION,892,1150,78,258
1200_40_4,INVERSION,783,1114,79,331
1200_45_0,INVERSION,868,1169,74,301
1200_45_1,INVERSION,400,614,55,214
1200_45_2,INVERSION,727,832,77,105
1200_45_3,INVERSION,1022,1342,79,320
1200_45_4,INVERSION,668,947,74,279
1200_50_0,INVERSION,992,1060,55,68
1200_50_1,INVERSION,1002,1292,74,290
1200_50_2,INVERSION,756,1095,75,339
1200_50_3,INVERSION,393,637,78,244
1200_50_4,INVERSION,458,565,71,107
1200_55_0,INVERSION,273,578,49,305
1200_55_1,INVERSION,766,1062,59,296
1200_55_2,INVERSION,605,974,70,369
1200_55_3,INVERSION,934,1031,67,97
1200_55_4,INVERSION,395,604,66,209
1200_60_0,INVERSION,645,866,57,221
1200_60_1,INVERSION,779,950,41,171
1200_60_2,INVERSION,544,659,44,115
1200_60_3,INVERSION,985,1128,44,143
1200_60_4,INVERSION,226,485,72,259
1200_65_0,INVERSION,527,675,41,148
1200_65_1,INVERSION,631,858,62,227
1200_65_2,INVERSION,273,361,52,88
1200_65_3,INVERSION,795,1135,50,340
1200_65_4,INVERSION,826,1097,39,271
1200_70_0,INVERSION,680,817,53,137
1200_70_1,INVERSION,299,653,40,354
1200_70_2,INVERSION,840,1128,46,288
1200_70_3,INVERSION,448,679,38,231
1200_70_4,INVERSION,274,433,46,159
1200_75_0,INVERSION,793,938,47,145
1200_75_1,INVERSION,492,886,37,394
1200_75_2,INVERSION,797,1034,47,237
1200_75_3,INVERSION,464,557,48,93
1200_75_4,INVERSION,530,875,32,345
1300_30_0,INVERSION,565,749,119,184
1300_30_1,INVERSION,892,1181,131,289
1300_30_2,INVERSION,920,1310,101,390
1300_30_3,INVERSION,1029,1414,128,385
1300_30_4,INVERSION,1103,1237,109,134
1300_35_0,INVERSION,401,502,93,101
1300_35_1,INVERSION,893,988,104,95
1300_35_2,INVERSION,509,826,90,317
1300_35_3,INVERSION,436,792,93,356
1300_35_4,INVERSION,1095,1277,89,182
1300_40_0,INVERSION,733,907,101,174
1300_40_1,INVERSION,983,1050,73,67
1300_40_2,INVERSION,654,728,97,74
1300_40_3,INVERSION,805,972,66,167
1300_40_4,INVERSION,460,755,74,295
1300_45_0,INVERSION,542,639,59,97
1300_45_1,INVERSION,1079,1375,63,296
1300_45_2,INVERSION,400,585,74,185
1300_45_3,INVERSION,869,1245,67,376
1300_45_4,INVERSION,574,829,87,255
1300_50_0,INVERSION,688,944,82,256
1300_50_1,INVERSION,530,920,57,390
1300_50_2,INVERSION,1103,1190,54,87
1300_50_3,INVERSION,682,799,67,117
1300_50_4,INVERSION,1097,1330,81,233
1300_55_0,INVERSION,1042,1395,48,353
1300_55_1,INVERSION,384,506,68,122
1300_55_2,INVERSION,355,774,73,419
1300_55_3,INVERSION,360,701,75,341
1300_55_4,INVERSION,824,1201,77,377
1300_60_0,INVERSION,426,717,50,291
1300_60_1,INVERSION,762,1037,47,275
1300_60_2,INVERSION,341,732,59,391
1300_60_3,INVERSION,299,415,67,116
1300_60_4,INVERSION,331,485,65,154
1300_65_0,INVERSION,341,548,41,207
1300_65_1,INVERSION,497,904,33,407
1300_65_2,INVERSION,327,635,53,308
1300_65_3,INVERSION,829,1180,50,351
1300_65_4,INVERSION,466,882,38,416
1300_70_0,INVERSION,940,1166,42,226
1300_70_1,INVERSION,751,862,55,111
1300_70_2,INVERSION,468,775,34,307
1300_70_3,INVERSION,899,1188,51,289
1300_70_4,INVERSION,624,1048,37,424
1300_75_0,INVERSION,601,884,38,283
1300_75_1,INVERSION,866,1117,43,251
1300_75_2,INVERSION,333,730,44,397
1300_75_3,INVERSION,806,956,37,150
1300_75_4,INVERSION,745,1080,45,335
1400_30_0,INVERSION,310,445,118,135
1400_30_1,INVERSION,820,1079,105,259
1400_30_2,INVERSION,453,767,103,314
1400_30_3,INVERSION,1108,1537,96,429
1400_30_4,INVERSION,325,463,129,138
1400_35_0,INVERSION,732,830,97,98
1400_35_1,INVERSION,512,621,135,109
1400_35_2,INVERSION,506,927,92,421
1400_35_3,INVERSION,228,485,96,257
1400_35_4,INVERSION,693,969,86,276
1400_40_0,INVERSION,880,1259,91,379
1400_40_1,INVERSION,439,598,75,159
1400_40_2,INVERSION,1234,1491,71,257
1400_40_3,INVERSION,998,1379,88,381
1400_40_4,INVERSION,1238,1344,78,106
1400_45_0,INVERSION,856,1251,56,395
1400_45_1,INVERSION,739,826,74,87
1400_45_2,INVERSION,1147,1431,64,284
1400_45_3,INVERSION,298,401,81,103
1400_45_4,INVERSION,813,915,63,102
1400_50_0,INVERSION,820,1157,66,337
1400_50_1,INVERSION,770,890,59,120
1400_50_2,INVERSION,728,916,63,188
1400_50_3,INVERSION,387,604,66,217
1400_50_4,INVERSION,292,750,54,458
1400_55_0,INVERSION,343,803,53,460
1400_55_1,INVERSION,1201,1365,67,164
1400_55_2,INVERSION,324,660,54,336
1400_55_3,INVERSION,430,876,51,446
1400_55_4,INVERSION,231,403,68,172
1400_60_0,INVERSION,894,1022,41,128
1400_60_1,INVERSION,813,1232,52,419
1400_60_2,INVERSION,1011,1447,63,436
1400_60_3,INVERSION,484,752,48,268
1400_60_4,INVERSION,789,1124,57,335
1400_65_0,INVERSION,877,1251,41,374
1400_65_1,INVERSION,718,977,41,259
1400_65_2,INVERSION,1083,1330,36,247
1400_65_3,INVERSION,1060,1159,43,99
1400_65_4,INVERSION,553,930,49,377
1400_70_0,INVERSION,1072,1268,37,196
1400_70_1,INVERSION,578,988,50,410
1400_70_2,INVERSION,367,553,38,186
1400_70_3,INVERSION,625,990,42,365
1400_70_4,INVERSION,862,1000,50,138
1400_75_0,INVERSION,649,1083,35,434
1400_75_1,INVERSION,909,1320,39,411
1400_75_2,INVERSION,1083,1188,38,105
1400_75_3,INVERSION,584,759,39,175
1400_75_4,INVERSION,880,1104,45,224
1500_30_0,INVERSION,1313,1559,92,246
1500_30_1,INVERSION,1051,1223,90,172
1500_30_2,INVERSION,475,634,165,159
1500_30_3,INVERSION,534,852,149,318
1500_30_4,INVERSION,706,1091,100,385
1500_35_0,INVERSION,971,1161,85,190
1500_35_1,INVERSION,1268,1564,75,296
1500_35_2,INVERSION,626,1052,70,426
1500_35_3,INVERSION,164,291,122,127
1500_35_4,INVERSION,1169,1552,101,383
1500_40_0,INVERSION,1283,1575,79,292
1500_40_1,INVERSION,1139,1524,72,385
1500_40_2,INVERSION,1233,1716,72,483
1500_40_3,INVERSION,718,790,76,72
1500_40_4,INVERSION,978,1348,64,370
1500_45_0,INVERSION,850,1023,61,173
1500_45_1,INVERSION,717,970,90,253
1500_45_2,INVERSION,271,596,60,325
1500_45_3,INVERSION,637,1114,70,477
1500_45_4,INVERSION,942,1197,87,255
1500_50_0,INVERSION,1273,1376,63,103
1500_50_1,INVERSION,736,971,49,235
1500_50_2,INVERSION,727,1219,73,492
1500_50_3,INVERSION,1303,1402,55,99
1500_50_4,INVERSION,287,646,57,359
1500_55_0,INVERSION,1091,1283,67,192
1500_55_1,INVERSION,832,1113,70,281
1500_55_2,INVERSION,653,740,55,87
1500_55_3,INVERSION,426,614,61,188
1500_55_4,INVERSION,342,577,64,235
1500_60_0,INVERSION,826,1236,38,410
1500_60_1,INVERSION,901,1357,52,456
1500_60_2,INVERSION,784,1026,58,242
1500_60_3,INVERSION,549,684,41,135
1500_60_4,INVERSION,1254,1666,63,412
1500_65_0,INVERSION,662,878,52,216
1500_65_1,INVERSION,1122,1465,66,343
1500_65_2,INVERSION,662,786,45,124
1500_65_3,INVERSION,723,1192,47,469
1500_65_4,INVERSION,457,920,36,463
1500_70_0,INVERSION,721,895,46,174
1500_70_1,INVERSION,332,468,55,136
1500_70_2,INVERSION,629,1077,39,448
1500_70_3,INVERSION,1000,1441,35,441
1500_70_4,INVERSION,647,1079,40,432
1500_75_0,INVERSION,1006,1426,32,420
1500_75_1,INVERSION,1010,1156,32,146
1500_75_2,INVERSION,876,1013,47,137
1500_75_3,INVERSION,1136,1250,43,114
1500_75_4,INVERSION,711,1025,30,314
1600_30_0,INVERSION,371,743,95,372
1600_30_1,INVERSION,806,1091,127,285
1600_30_2,INVERSION,655,853,97,198
1600_30_3,INVERSION,145,280,133,135
1600_30_4,INVERSION,300,690,100,390
1600_35_0,INVERSION,1379,1808,83,429
1600_35_1,INVERSION,1103,1441,120,338
1600_35_2,INVERSION,1210,1365,121,155
1600_35_3,INVERSION,738,904,82,166
1600_35_4,INVERSION,827,1000,71,173
1600_40_0,INVERSION,317,521,66,204
1600_40_1,INVERSION,503,575,67,72
1600_40_2,INVERSION,916,1123,76,207
1600_40_3,INVERSION,516,657,108,141
1600_40_4,INVERSION,242,475,74,233
1600_45_0,INVERSION,501,1030,77,529
1600_45_1,INVERSION,425,565,57,140
1600_45_2,INVERSION,658,787,58,129
1600_45_3,INVERSION,360,466,63,106
1600_45_4,INVERSION,458,574,64,116
1600_50_0,INVERSION,667,1059,59,392
1600_50_1,INVERSION,786,1052,81,266
1600_50_2,INVERSION,720,952,57,232
1600_50_3,INVERSION,1052,1222,73,170
1600_50_4,INVERSION,618,738,82,120
1600_55_0,INVERSION,1194,1357,61,163
1600_55_1,INVERSION,1204,1352,57,148
1600_55_2,INVERSION,468,866,63,398
1600_55_3,INVERSION,410,796,52,386
1600_55_4,INVERSION,551,761,48,210
1600_60_0,INVERSION,725,1130,46,405
1600_60_1,INVERSION,416,791,76,375
1600_60_2,INVERSION,812,1259,55,447
1600_60_3,INVERSION,725,1171,40,446
1600_60_4,INVERSION,1102,1334,56,232
1600_65_0,INVERSION,583,867,60,284
1600_65_1,INVERSION,422,568,39,146
1600_65_2,INVERSION,735,974,43,239
1600_65_3,INVERSION,1195,1344,63,149
1600_65_4,INVERSION,510,703,50,193
1600_70_0,INVERSION,1047,1564,35,517
1600_70_1,INVERSION,674,1072,49,398
1600_70_2,INVERSION,735,1177,56,442
1600_70_3,INVERSION,614,1128,48,514
1600_70_4,INVERSION,861,1089,46,228
1600_75_0,INVERSION,906,1299,31,393
1600_75_1,INVERSION,773,982,41,209
1600_75_2,INVERSION,539,962,35,423
1600_75_3,INVERSION,1185,1321,31,136
1600_75_4,INVERSION,428,650,29,222
1700_30_0,INVERSION,1429,1826,158,397
1700_30_1,INVERSION,441,637,146,196
1700_30_2,INVERSION,1247,1794,120,547
1700_30_3,INVERSION,1166,1294,123,128
1700_30_4,INVERSION,1415,1823,88,408
1700_35_0,INVERSION,749,1001,90,252
1700_35_1,INVERSION,703,816,109,113
1700_35_2,INVERSION,200,663,122,463
1700_35_3,INVERSION,1055,1562,96,507
1700_35_4,INVERSION,1065,1269,74,204
1700_40_0,INVERSION,454,631,90,177
1700_40_1,INVERSION,1239,1653,75,414
1700_40_2,INVERSION,330,729,79,399
1700_40_3,INVERSION,524,981,69,457
1700_40_4,INVERSION,1307,1454,96,147
1700_45_0,INVERSION,854,1181,63,327
1700_45_1,INVERSION,1411,1520,73,109
1700_45_2,INVERSION,957,1467,78,510
1700_45_3,INVERSION,1470,1923,94,453
1700_45_4,INVERSION,242,420,65,178
1700_50_0,INVERSION,324,577,91,253
1700_50_1,INVERSION,1013,1448,61,435
1700_50_2,INVERSION,1429,1906,79,477
1700_50_3,INVERSION,469,1030,61,561
1700_50_4,INVERSION,923,1149,74,226
1700_55_0,INVERSION,926,1440,50,514
1700_55_1,INVERSION,1201,1303,59,102
1700_55_2,INVERSION,658,864,53,206
1700_55_3,INVERSION,1318,1612,48,294
1700_55_4,INVERSION,294,486,56,192
1700_60_0,INVERSION,359,506,42,147
1700_60_1,INVERSION,459,659,58,200
1700_60_2,INVERSION,660,1133,55,473
1700_60_3,INVERSION,1146,1352,53,206
1700_60_4,INVERSION,312,433,55,121
1700_65_0,INVERSION,1205,1567,33,362
1700_65_1,INVERSION,909,1460,58,551
1700_65_2,INVERSION,1090,1343,40,253
1700_65_3,INVERSION,421,907,35,486
1700_65_4,INVERSION,1179,1654,52,475
1700_70_0,INVERSION,1294,1518,47,224
1700_70_1,INVERSION,871,1208,58,337
1700_70_2,INVERSION,476,737,33,261
1700_70_3,INVERSION,973,1101,34,128
1700_70_4,INVERSION,1051,1405,45,354
1700_75_0,INVERSION,936,1354,38,418
1700_75_1,INVERSION,1175,1521,40,346
1700_75_2,INVERSION,559,856,32,297
1700_75_3,INVERSION,764,1282,43,518
1700_75_4,INVERSION,771,1287,33,516
1800_30_0,INVERSION,1443,1744,100,301
1800_30_1,INVERSION,660,860,100,200
1800_30_2,INVERSION,980,1201,161,221
1800_30_3,INVERSION,202,713,109,511
1800_30_4,INVERSION,1595,1779,136,184
1800_35_0,INVERSION,1066,1272,100,206
1800_35_1,INVERSION,269,839,75,570
1800_35_2,INVERSION,572,924,87,352
1800_35_3,INVERSION,815,1285,100,470
1800_35_4,INVERSION,1130,1641,111,511
1800_40_0,INVERSION,300,409,82,109
1800_40_1,INVERSION,1572,2078,81,506
1800_40_2,INVERSION,399,572,100,173
1800_40_3,INVERSION,333,739,70,406
1800_40_4,INVERSION,1390,1906,103,516
1800_45_0,INVERSION,1092,1539,71,447
1800_45_1,INVERSION,664,787,74,123
1800_45_2,INVERSION,983,1459,63,476
1800_45_3,INVERSION,1352,1664,96,312
1800_45_4,INVERSION,687,810,88,123
1800_50_0,INVERSION,614,705,49,91
1800_50_1,INVERSION,1156,1268,51,112
1800_50_2,INVERSION,1355,1936,79,581
1800_50_3,INVERSION,1073,1528,77,455
1800_50_4,INVERSION,798,1190,48,392
1800_55_0,INVERSION,674,1086,63,412
1800_55_1,INVERSION,737,921,55,184
1800_55_2,INVERSION,1053,1465,58,412
1800_55_3,INVERSION,358,598,45,240
1800_55_4,INVERSION,584,1078,61,494
1800_60_0,INVERSION,530,1029,42,499
1800_60_1,INVERSION,1163,1586,46,423
1800_60_2,INVERSION,543,655,45,112
1800_60_3,INVERSION,1051,1610,46,559
1800_60_4,INVERSION,531,798,55,267
1800_65_0,INVERSION,603,878,48,275
1800_65_1,INVERSION,699,883,41,184
1800_65_2,INVERSION,1009,1335,38,326
1800_65_3,INVERSION,1148,1323,51,175
1800_65_4,INVERSION,466,670,54,204
1800_70_0,INVERSION,1302,1632,52,330
1800_70_1,INVERSION,913,1248,65,335
1800_70_2,INVERSION,1193,1394,45,201
1800_70_3,INVERSION,836,1195,40,359
1800_70_4,INVERSION,351,642,40,291
1800_75_0,INVERSION,1195,1776,42,581
1800_75_1,INVERSION,908,1212,29,304
1800_75_2,INVERSION,956,1530,39,574
1800_75_3,INVERSION,1056,1423,41,367
1800_75_4,INVERSION,1126,1692,47,566
1900_30_0,INVERSION,1728,1987,101,259
1900_30_1,INVERSION,1572,2166,86,594
1900_30_2,INVERSION,563,1151,100,588
1900_30_3,INVERSION,553,861,128,308
1900_30_4,INVERSION,546,779,103,233
1900_35_0,INVERSION,1652,1766,86,114
1900_35_1,INVERSION,724,802,90,78
1900_35_2,INVERSION,1356,1622,115,266
1900_35_3,INVERSION,508,691,98,183
1900_35_4,INVERSION,720,1316,100,596
1900_40_0,INVERSION,1339,1736,98,397
1900_40_1,INVERSION,555,659,76,104
1900_40_2,INVERSION,991,1213,72,222
1900_40_3,INVERSION,345,806,69,461
1900_40_4,INVERSION,1239,1778,70,539
1900_45_0,INVERSION,764,1238,66,474
1900_45_1,INVERSION,1102,1475,72,373
1900_45_2,INVERSION,675,1176,79,501
1900_45_3,INVERSION,878,1241,78,363
1900_45_4,INVERSION,542,1125,79,583
1900_50_0,INVERSION,566,944,74,378
1900_50_1,INVERSION,1080,1693,64,613
1900_50_2,INVERSION,931,1346,50,415
1900_50_3,INVERSION,629,881,72,252
1900_50_4,INVERSION,851,1006,54,155
1900_55_0,INVERSION,1060,1635,78,575
1900_55_1,INVERSION,629,1240,55,611
1900_55_2,INVERSION,307,865,78,558
1900_55_3,INVERSION,1310,1437,50,127
1900_55_4,INVERSION,470,786,61,316
1900_60_0,INVERSION,1103,1573,54,470
1900_60_1,INVERSION,461,800,43,339
1900_60_2,INVERSION,743,1132,46,389
1900_60_3,INVERSION,527,1091,39,564
1900_60_4,INVERSION,995,1541,55,546
1900_65_0,INVERSION,1352,1708,42,356
1900_65_1,INVERSION,616,919,43,303
1900_65_2,INVERSION,821,1116,38,295
1900_65_3,INVERSION,542,1048,39,506
1900_65_4,INVERSION,1260,1656,43,396
1900_70_0,INVERSION,1075,1224,37,149
1900_70_1,INVERSION,546,978,42,432
1900_70_2,INVERSION,537,1048,39,511
1900_70_3,INVERSION,1292,1576,45,284
1900_70_4,INVERSION,1164,1682,43,518
1900_75_0,INVERSION,414,659,34,245
1900_75_1,INVERSION,919,1163,40,244
1900_75_2,INVERSION,450,748,39,298
1900_75_3,INVERSION,977,1513,34,536
1900_75_4,INVERSION,1336,1774,36,438
