,real_type,real_start,real_end,read_count,var_size,type,start,end,time(s)
500_30_0,INVERSION,58,102,130,44,INVERSION,58,101,0.55916428565979
500_30_1,INVERSION,320,375,123,55,TRANSLOCATION,373,0,0.531851053237915
500_30_2,INVERSION,427,522,115,95,TRANSLOCATION,428,0,0.4973294734954834
500_30_3,INVERSION,201,351,120,150,TANDEM,358,201,0.5075428485870361
500_30_4,INVERSION,106,218,231,112,INVERSION,106,217,1.0025854110717773
500_35_0,INVERSION,296,449,117,153,TANDEM,447,297,0.5249245166778564
500_35_1,INVERSION,345,420,102,75,INVERSION,346,418,0.44843578338623047
500_35_2,INVERSION,49,186,134,137,TANDEM,184,50,0.6092562675476074
500_35_3,INVERSION,82,136,97,54,INVERSION,84,133,0.44347572326660156
500_35_4,INVERSION,381,466,157,85,TRANSLOCATION,381,0,0.6898148059844971
500_40_0,INVERSION,343,496,76,153,TRANSLOCATION,343,0,0.3606588840484619
500_40_1,INVERSION,307,333,80,26,INVERSION,324,311,0.36811113357543945
500_40_2,INVERSION,197,280,67,83,INVERSION,197,279,0.31420326232910156
500_40_3,INVERSION,57,88,77,31,INVERSION,500,500,0.3699460029602051
500_40_4,INVERSION,70,108,81,38,INVERSION,70,107,0.37604737281799316
500_45_0,INVERSION,74,239,75,165,INVERSION,77,235,0.36574697494506836
500_45_1,INVERSION,180,285,64,105,TRANSLOCATION,291,0,0.30901360511779785
500_45_2,INVERSION,113,149,58,36,INVERSION,113,119,0.2853395938873291
500_45_3,INVERSION,185,251,70,66,TRANSLOCATION,250,0,0.3428959846496582
500_45_4,INVERSION,403,458,73,55,INVERSION,500,500,0.3522942066192627
500_50_0,INVERSION,174,243,72,69,INVERSION,176,251,0.371021032333374
500_50_1,INVERSION,186,329,96,143,INVERSION,186,328,0.47658395767211914
500_50_2,INVERSION,176,227,71,51,INVERSION,164,226,0.3538696765899658
500_50_3,INVERSION,105,237,83,132,INVERSION,105,236,0.41400909423828125
500_50_4,INVERSION,239,277,82,38,INVERSION,239,276,0.4158618450164795
500_55_0,INVERSION,203,259,62,56,INVERSION,203,258,0.32831716537475586
500_55_1,INVERSION,192,337,58,145,INVERSION,193,335,0.3113110065460205
500_55_2,INVERSION,312,394,73,82,INVERSION,312,407,0.3838200569152832
500_55_3,INVERSION,195,240,49,45,TRANSLOCATION,238,0,0.26280736923217773
500_55_4,INVERSION,256,299,56,43,INVERSION,256,298,0.29924535751342773
500_60_0,INVERSION,176,213,62,37,INVERSION,178,210,0.3356454372406006
500_60_1,INVERSION,318,372,62,54,INVERSION,318,326,0.34179019927978516
500_60_2,INVERSION,346,381,61,35,INVERSION,346,380,0.3310823440551758
500_60_3,INVERSION,337,452,64,115,TRANSLOCATION,337,0,0.3486335277557373
500_60_4,INVERSION,171,313,59,142,INVERSION,169,312,0.3233366012573242
500_65_0,INVERSION,277,316,57,39,INVERSION,278,314,0.32097291946411133
500_65_1,INVERSION,180,239,52,59,INVERSION,180,239,0.30029749870300293
500_65_2,INVERSION,366,435,34,69,TRANSLOCATION,434,0,0.19762897491455078
500_65_3,INVERSION,154,254,51,100,INVERSION,157,269,0.29021549224853516
500_65_4,INVERSION,347,429,48,82,TRANSLOCATION,326,0,0.2633073329925537
500_70_0,INVERSION,272,433,49,161,TRANSLOCATION,272,0,0.2814927101135254
500_70_1,INVERSION,332,393,54,61,INVERSION,332,392,0.31592607498168945
500_70_2,INVERSION,294,370,51,76,INVERSION,295,368,0.2950751781463623
500_70_3,INVERSION,158,292,41,134,INVERSION,153,311,0.2459549903869629
500_70_4,INVERSION,351,491,41,140,TRANSLOCATION,331,0,0.2399141788482666
500_75_0,INVERSION,330,476,34,146,INVERSION,500,500,0.20371699333190918
500_75_1,INVERSION,132,261,40,129,INVERSION,113,260,0.2434389591217041
500_75_2,INVERSION,218,359,43,141,INVERSION,218,358,0.25882697105407715
500_75_3,INVERSION,305,442,43,137,TRANSLOCATION,287,0,0.2577786445617676
500_75_4,INVERSION,193,304,41,111,INVERSION,193,303,0.24538040161132812
600_30_0,INVERSION,135,289,87,154,TRANSLOCATION,135,0,0.5030534267425537
600_30_1,INVERSION,189,324,122,135,INVERSION,183,323,0.6856598854064941
600_30_2,INVERSION,379,550,92,171,TRANSLOCATION,379,0,0.509580135345459
600_30_3,INVERSION,414,475,159,61,INVERSION,265,473,0.8851661682128906
600_30_4,INVERSION,337,373,134,36,TRANSLOCATION,372,0,0.754249095916748
600_35_0,INVERSION,381,552,89,171,TANDEM,551,381,0.5245263576507568
600_35_1,INVERSION,430,527,101,97,TRANSLOCATION,431,0,0.5813875198364258
600_35_2,INVERSION,509,698,90,189,TRANSLOCATION,510,0,0.5210356712341309
600_35_3,INVERSION,219,359,99,140,INVERSION,219,358,0.578655481338501
600_35_4,INVERSION,275,428,132,153,INVERSION,276,426,0.7792389392852783
600_40_0,INVERSION,492,578,105,86,TRANSLOCATION,492,0,0.6380977630615234
600_40_1,INVERSION,375,453,75,78,INVERSION,366,452,0.4617431163787842
600_40_2,INVERSION,130,233,72,103,INVERSION,130,232,0.4560868740081787
600_40_3,INVERSION,506,680,65,174,TRANSLOCATION,507,0,0.39609265327453613
600_40_4,INVERSION,467,587,77,120,TRANSLOCATION,467,0,0.470717191696167
600_45_0,INVERSION,293,456,94,163,INVERSION,293,455,0.5989506244659424
600_45_1,INVERSION,485,592,121,107,TRANSLOCATION,485,0,0.7683897018432617
600_45_2,INVERSION,133,208,73,75,INVERSION,134,207,0.4719886779785156
600_45_3,INVERSION,161,249,62,88,INVERSION,162,247,0.3894951343536377
600_45_4,INVERSION,195,299,59,104,TRANSLOCATION,297,0,0.38310790061950684
600_50_0,INVERSION,372,565,73,193,TRANSLOCATION,372,0,0.481304407119751
600_50_1,INVERSION,210,349,57,139,TRANSLOCATION,210,0,0.3747696876525879
600_50_2,INVERSION,313,415,53,102,INVERSION,313,414,0.34981441497802734
600_50_3,INVERSION,318,364,59,46,INVERSION,307,363,0.39089250564575195
600_50_4,INVERSION,93,253,94,160,INVERSION,93,252,0.6289577484130859
600_55_0,INVERSION,455,577,43,122,TRANSLOCATION,455,0,0.29534220695495605
600_55_1,INVERSION,290,399,60,109,INVERSION,278,398,0.41516637802124023
600_55_2,INVERSION,264,437,63,173,INVERSION,264,436,0.4456453323364258
600_55_3,INVERSION,143,256,55,113,INVERSION,144,254,0.4154207706451416
600_55_4,INVERSION,212,299,50,87,TRANSLOCATION,298,0,0.34790992736816406
600_60_0,INVERSION,391,486,38,95,INVERSION,391,485,0.2674524784088135
600_60_1,INVERSION,181,237,57,56,INVERSION,182,235,0.4206504821777344
600_60_2,INVERSION,128,309,43,181,TRANSLOCATION,308,0,0.31200480461120605
600_60_3,INVERSION,395,594,48,199,TRANSLOCATION,383,0,0.343017578125
600_60_4,INVERSION,284,323,40,39,INVERSION,284,295,0.28885984420776367
600_65_0,INVERSION,300,458,43,158,INVERSION,281,466,0.326185941696167
600_65_1,INVERSION,430,546,40,116,TRANSLOCATION,430,0,0.28778553009033203
600_65_2,INVERSION,119,318,55,199,INVERSION,93,317,0.4119377136230469
600_65_3,INVERSION,159,315,45,156,INVERSION,159,314,0.33673644065856934
600_65_4,INVERSION,311,415,54,104,INVERSION,288,413,0.3985269069671631
600_70_0,INVERSION,466,578,33,112,TRANSLOCATION,442,0,0.2582409381866455
600_70_1,INVERSION,188,307,42,119,INVERSION,188,306,0.3276395797729492
600_70_2,INVERSION,192,290,47,98,INVERSION,192,289,0.3611009120941162
600_70_3,INVERSION,281,418,50,137,INVERSION,248,443,0.37528252601623535
600_70_4,INVERSION,454,651,47,197,TRANSLOCATION,433,0,0.3549201488494873
600_75_0,INVERSION,328,376,42,48,INVERSION,329,343,0.3249094486236572
600_75_1,INVERSION,160,342,44,182,INVERSION,161,340,0.34767746925354004
600_75_2,INVERSION,403,486,41,83,INVERSION,396,485,0.31690502166748047
600_75_3,INVERSION,243,422,32,179,INVERSION,238,450,0.25542187690734863
600_75_4,INVERSION,325,492,37,167,TRANSLOCATION,325,0,0.29448819160461426
700_30_0,INVERSION,306,485,161,179,INVERSION,306,484,1.0994138717651367
700_30_1,INVERSION,418,518,89,100,INVERSION,410,517,0.6308133602142334
700_30_2,INVERSION,571,741,91,170,TRANSLOCATION,571,0,0.6287171840667725
700_30_3,INVERSION,538,584,95,46,INVERSION,538,583,0.647545337677002
700_30_4,INVERSION,558,708,163,150,TRANSLOCATION,552,0,1.1155683994293213
700_35_0,INVERSION,190,342,96,152,INVERSION,192,339,0.7196569442749023
700_35_1,INVERSION,567,674,109,107,TRANSLOCATION,567,0,0.7718539237976074
700_35_2,INVERSION,534,635,71,101,INVERSION,700,700,0.5124220848083496
700_35_3,INVERSION,468,686,94,218,TRANSLOCATION,460,0,0.6938488483428955
700_35_4,INVERSION,225,277,84,52,INVERSION,227,274,0.6267859935760498
700_40_0,INVERSION,333,394,78,61,INVERSION,334,392,0.5960407257080078
700_40_1,INVERSION,337,493,112,156,INVERSION,337,492,0.8399679660797119
700_40_2,INVERSION,184,216,65,32,INVERSION,187,196,0.4967234134674072
700_40_3,INVERSION,174,231,69,57,INVERSION,174,230,0.5507519245147705
700_40_4,INVERSION,80,175,82,95,INVERSION,80,174,0.6246907711029053
700_45_0,INVERSION,590,718,74,128,TRANSLOCATION,589,0,0.5760645866394043
700_45_1,INVERSION,134,267,125,133,INVERSION,134,275,0.9849698543548584
700_45_2,INVERSION,204,258,74,54,INVERSION,204,257,0.5882928371429443
700_45_3,INVERSION,183,222,81,39,INVERSION,183,198,0.644040584564209
700_45_4,INVERSION,435,493,59,58,TRANSLOCATION,492,0,0.46881794929504395
700_50_0,INVERSION,381,480,68,99,INVERSION,381,479,0.551133394241333
700_50_1,INVERSION,350,547,90,197,INVERSION,350,560,0.7418742179870605
700_50_2,INVERSION,563,637,88,74,TRANSLOCATION,561,0,0.7331855297088623
700_50_3,INVERSION,395,488,67,93,INVERSION,396,486,0.5532577037811279
700_50_4,INVERSION,342,502,62,160,INVERSION,342,501,0.5270369052886963
700_55_0,INVERSION,505,547,49,42,INVERSION,487,546,0.42006731033325195
700_55_1,INVERSION,570,651,50,81,TRANSLOCATION,570,0,0.43168091773986816
700_55_2,INVERSION,386,544,59,158,INVERSION,370,543,0.4995002746582031
700_55_3,INVERSION,320,409,58,89,INVERSION,311,415,0.5110230445861816
700_55_4,INVERSION,144,365,65,221,TRANSLOCATION,144,0,0.5677478313446045
700_60_0,INVERSION,396,565,57,169,INVERSION,396,564,0.5149004459381104
700_60_1,INVERSION,392,554,71,162,INVERSION,392,553,0.6390361785888672
700_60_2,INVERSION,399,530,50,131,INVERSION,400,528,0.455197811126709
700_60_3,INVERSION,400,578,56,178,INVERSION,400,577,0.48965978622436523
700_60_4,INVERSION,230,308,45,78,INVERSION,206,331,0.40625786781311035
700_65_0,INVERSION,330,524,50,194,INVERSION,321,522,0.4657011032104492
700_65_1,INVERSION,487,575,47,88,INVERSION,477,574,0.4352703094482422
700_65_2,INVERSION,440,623,54,183,TRANSLOCATION,427,0,0.5012674331665039
700_65_3,INVERSION,464,547,39,83,TRANSLOCATION,546,0,0.3630082607269287
700_65_4,INVERSION,507,569,61,62,INVERSION,502,521,0.5569114685058594
700_70_0,INVERSION,205,382,55,177,INVERSION,205,381,0.5391087532043457
700_70_1,INVERSION,506,657,38,151,TRANSLOCATION,506,0,0.3625218868255615
700_70_2,INVERSION,312,531,42,219,INVERSION,312,563,0.4124929904937744
700_70_3,INVERSION,436,613,51,177,TRANSLOCATION,436,0,0.48367977142333984
700_70_4,INVERSION,351,421,40,70,INVERSION,351,361,0.3886837959289551
700_75_0,INVERSION,148,221,35,73,INVERSION,148,220,0.35365939140319824
700_75_1,INVERSION,349,455,38,106,INVERSION,324,453,0.3788895606994629
700_75_2,INVERSION,156,327,41,171,TRANSLOCATION,326,0,0.4091510772705078
700_75_3,INVERSION,301,465,36,164,TRANSLOCATION,279,0,0.36275148391723633
700_75_4,INVERSION,286,373,39,87,INVERSION,288,313,0.394207239151001
800_30_0,INVERSION,338,526,113,188,TANDEM,525,326,0.9380567073822021
800_30_1,INVERSION,495,552,91,57,TRANSLOCATION,498,0,0.7463910579681396
800_30_2,INVERSION,295,440,136,145,INVERSION,295,439,1.1623785495758057
800_30_3,INVERSION,305,348,91,43,TRANSLOCATION,305,0,0.7826106548309326
800_30_4,INVERSION,388,475,119,87,INVERSION,389,473,0.9879729747772217
800_35_0,INVERSION,343,466,103,123,INVERSION,343,465,0.8986713886260986
800_35_1,INVERSION,366,572,113,206,TRANSLOCATION,570,0,1.0043354034423828
800_35_2,INVERSION,391,464,108,73,INVERSION,392,462,0.9585483074188232
800_35_3,INVERSION,259,319,99,60,INVERSION,262,315,0.8706388473510742
800_35_4,INVERSION,500,623,102,123,INVERSION,500,622,0.8927693367004395
800_40_0,INVERSION,560,796,66,236,TRANSLOCATION,563,0,0.6187939643859863
800_40_1,INVERSION,645,766,95,121,TRANSLOCATION,636,0,0.8893246650695801
800_40_2,INVERSION,563,680,83,117,INVERSION,563,679,0.7571027278900146
800_40_3,INVERSION,193,347,78,154,INVERSION,193,346,0.7461929321289062
800_40_4,INVERSION,298,363,82,65,INVERSION,298,362,0.7755856513977051
800_45_0,INVERSION,630,767,70,137,TRANSLOCATION,630,0,0.6794519424438477
800_45_1,INVERSION,383,646,77,263,INVERSION,362,645,0.7354190349578857
800_45_2,INVERSION,372,482,59,110,INVERSION,372,481,0.5707294940948486
800_45_3,INVERSION,281,368,60,87,INVERSION,281,367,0.5943291187286377
800_45_4,INVERSION,552,723,77,171,TRANSLOCATION,549,0,0.7476987838745117
800_50_0,INVERSION,449,563,73,114,INVERSION,429,562,0.7322824001312256
800_50_1,INVERSION,220,324,67,104,INVERSION,214,322,0.6796739101409912
800_50_2,INVERSION,323,433,53,110,INVERSION,323,432,0.55013108253479
800_50_3,INVERSION,515,602,53,87,INVERSION,489,610,0.5370974540710449
800_50_4,INVERSION,137,400,55,263,INVERSION,122,399,0.5699477195739746
800_55_0,INVERSION,409,651,53,242,INVERSION,411,668,0.5628514289855957
800_55_1,INVERSION,351,615,66,264,INVERSION,351,614,0.7079439163208008
800_55_2,INVERSION,389,560,49,171,INVERSION,389,559,0.530386209487915
800_55_3,INVERSION,345,577,60,232,INVERSION,326,575,0.6405842304229736
800_55_4,INVERSION,557,822,76,265,TRANSLOCATION,557,0,0.798839807510376
800_60_0,INVERSION,278,336,45,58,INVERSION,244,293,0.4989612102508545
800_60_1,INVERSION,543,593,54,50,INVERSION,543,560,0.5886828899383545
800_60_2,INVERSION,154,302,44,148,TRANSLOCATION,154,0,0.4960963726043701
800_60_3,INVERSION,551,814,45,263,TRANSLOCATION,552,0,0.49646592140197754
800_60_4,INVERSION,307,476,60,169,INVERSION,307,475,0.6518955230712891
800_65_0,INVERSION,324,425,40,101,INVERSION,311,429,0.46242594718933105
800_65_1,INVERSION,282,402,45,120,INVERSION,282,417,0.5224881172180176
800_65_2,INVERSION,606,771,42,165,TRANSLOCATION,607,0,0.4817779064178467
800_65_3,INVERSION,310,472,39,162,INVERSION,310,471,0.4564635753631592
800_65_4,INVERSION,213,398,44,185,INVERSION,215,417,0.5037808418273926
800_70_0,INVERSION,201,416,42,215,INVERSION,189,414,0.5062613487243652
800_70_1,INVERSION,495,583,39,88,INVERSION,462,517,0.4564836025238037
800_70_2,INVERSION,619,703,57,84,TRANSLOCATION,619,0,0.6789863109588623
800_70_3,INVERSION,337,601,38,264,INVERSION,337,600,0.45282697677612305
800_70_4,INVERSION,548,770,34,222,TRANSLOCATION,548,0,0.40666675567626953
800_75_0,INVERSION,219,462,41,243,INVERSION,219,461,0.5130512714385986
800_75_1,INVERSION,170,286,29,116,INVERSION,167,310,0.3693816661834717
800_75_2,INVERSION,287,459,30,172,INVERSION,287,482,0.37696051597595215
800_75_3,INVERSION,621,687,36,66,INVERSION,593,647,0.43766140937805176
800_75_4,INVERSION,225,358,41,133,INVERSION,225,357,0.514474630355835
900_30_0,INVERSION,654,737,105,83,INVERSION,654,737,1.0502946376800537
900_30_1,INVERSION,187,297,130,110,INVERSION,188,295,1.2876455783843994
900_30_2,INVERSION,763,977,113,214,TRANSLOCATION,763,0,1.1000566482543945
900_30_3,INVERSION,638,838,107,200,TRANSLOCATION,638,0,1.0559852123260498
900_30_4,INVERSION,748,881,88,133,TRANSLOCATION,748,0,0.8759980201721191
900_35_0,INVERSION,495,635,126,140,INVERSION,484,634,1.3184542655944824
900_35_1,INVERSION,288,344,99,56,INVERSION,288,343,1.0212337970733643
900_35_2,INVERSION,277,343,135,66,INVERSION,277,342,1.4298717975616455
900_35_3,INVERSION,735,942,102,207,TRANSLOCATION,735,0,1.0486831665039062
900_35_4,INVERSION,790,1030,111,240,TRANSLOCATION,791,0,1.1292524337768555
900_40_0,INVERSION,429,542,66,113,INVERSION,429,541,0.7269933223724365
900_40_1,INVERSION,762,912,100,150,TRANSLOCATION,762,0,1.117642879486084
900_40_2,INVERSION,297,557,80,260,INVERSION,285,554,0.9200773239135742
900_40_3,INVERSION,478,657,86,179,INVERSION,478,656,0.9669413566589355
900_40_4,INVERSION,251,522,99,271,INVERSION,227,520,1.1324830055236816
900_45_0,INVERSION,603,674,70,71,INVERSION,603,673,0.8310518264770508
900_45_1,INVERSION,410,585,69,175,INVERSION,400,599,0.8297429084777832
900_45_2,INVERSION,451,526,95,75,INVERSION,451,538,1.1014580726623535
900_45_3,INVERSION,297,393,53,96,INVERSION,298,391,0.6238350868225098
900_45_4,INVERSION,302,376,77,74,INVERSION,302,375,0.880537748336792
900_50_0,INVERSION,179,376,73,197,INVERSION,179,375,0.9040653705596924
900_50_1,INVERSION,705,808,66,103,TRANSLOCATION,705,0,0.787804126739502
900_50_2,INVERSION,332,519,64,187,INVERSION,329,518,0.7961797714233398
900_50_3,INVERSION,584,809,75,225,TRANSLOCATION,584,0,0.8914544582366943
900_50_4,INVERSION,650,774,84,124,INVERSION,644,773,1.0074992179870605
900_55_0,INVERSION,629,840,68,211,TRANSLOCATION,629,0,0.8621337413787842
900_55_1,INVERSION,650,818,64,168,TRANSLOCATION,650,0,0.7983613014221191
900_55_2,INVERSION,375,592,46,217,INVERSION,375,591,0.581096887588501
900_55_3,INVERSION,770,1039,50,269,TRANSLOCATION,770,0,0.63250732421875
900_55_4,INVERSION,311,374,64,63,INVERSION,353,373,0.8108196258544922
900_60_0,INVERSION,691,925,70,234,TRANSLOCATION,670,0,0.916684627532959
900_60_1,INVERSION,219,450,71,231,INVERSION,219,449,0.9404387474060059
900_60_2,INVERSION,602,854,46,252,INVERSION,900,900,0.5956482887268066
900_60_3,INVERSION,304,549,64,245,INVERSION,305,569,0.8441195487976074
900_60_4,INVERSION,598,891,60,293,TRANSLOCATION,585,0,0.7950038909912109
900_65_0,INVERSION,317,379,38,62,INVERSION,317,340,0.5236587524414062
900_65_1,INVERSION,383,513,59,130,INVERSION,367,510,0.8150408267974854
900_65_2,INVERSION,367,574,48,207,TRANSLOCATION,573,0,0.6617870330810547
900_65_3,INVERSION,348,477,58,129,INVERSION,348,508,0.8079624176025391
900_65_4,INVERSION,293,352,48,59,INVERSION,293,317,0.6613311767578125
900_70_0,INVERSION,532,724,45,192,INVERSION,532,723,0.6380548477172852
900_70_1,INVERSION,574,725,37,151,INVERSION,900,900,0.5336310863494873
900_70_2,INVERSION,206,373,40,167,INVERSION,206,372,0.568204402923584
900_70_3,INVERSION,258,552,36,294,TRANSLOCATION,236,0,0.5170879364013672
900_70_4,INVERSION,302,469,37,167,INVERSION,302,468,0.53330397605896
900_75_0,INVERSION,489,787,54,298,TRANSLOCATION,489,0,0.7918615341186523
900_75_1,INVERSION,399,668,37,269,TRANSLOCATION,667,0,0.5542943477630615
900_75_2,INVERSION,242,384,36,142,INVERSION,222,404,0.53782057762146
900_75_3,INVERSION,353,486,56,133,INVERSION,354,484,0.8432681560516357
900_75_4,INVERSION,673,912,42,239,TRANSLOCATION,673,0,0.6405816078186035
1000_30_0,INVERSION,406,638,95,232,TANDEM,637,406,1.1131205558776855
1000_30_1,INVERSION,82,321,111,239,TANDEM,319,83,1.2967908382415771
1000_30_2,INVERSION,124,240,174,116,INVERSION,125,238,1.9784879684448242
1000_30_3,INVERSION,455,556,140,101,INVERSION,441,555,1.5745599269866943
1000_30_4,INVERSION,611,885,98,274,TRANSLOCATION,611,0,1.1249873638153076
1000_35_0,INVERSION,405,695,95,290,TANDEM,1000,1000,1.1602249145507812
1000_35_1,INVERSION,504,638,126,134,INVERSION,504,661,1.5486805438995361
1000_35_2,INVERSION,698,968,99,270,TRANSLOCATION,698,0,1.2075920104980469
1000_35_3,INVERSION,700,913,151,213,TANDEM,912,700,1.8009228706359863
1000_35_4,INVERSION,276,427,79,151,INVERSION,276,426,0.9596500396728516
1000_40_0,INVERSION,876,1145,80,269,TRANSLOCATION,876,0,1.0202441215515137
1000_40_1,INVERSION,668,833,117,165,INVERSION,638,832,1.494997262954712
1000_40_2,INVERSION,166,308,90,142,INVERSION,166,307,1.1421408653259277
1000_40_3,INVERSION,265,362,107,97,INVERSION,246,361,1.4137065410614014
1000_40_4,INVERSION,872,1046,83,174,TRANSLOCATION,872,0,1.0373966693878174
1000_45_0,INVERSION,459,585,107,126,INVERSION,459,584,1.4562382698059082
1000_45_1,INVERSION,736,911,101,175,TRANSLOCATION,736,0,1.357658863067627
1000_45_2,INVERSION,199,507,70,308,TRANSLOCATION,506,0,0.956345796585083
1000_45_3,INVERSION,740,834,63,94,TRANSLOCATION,741,0,0.8443286418914795
1000_45_4,INVERSION,229,504,93,275,INVERSION,229,503,1.2697603702545166
1000_50_0,INVERSION,169,377,63,208,INVERSION,169,376,0.9047963619232178
1000_50_1,INVERSION,402,497,69,95,INVERSION,402,496,0.9651429653167725
1000_50_2,INVERSION,792,1019,48,227,TRANSLOCATION,759,0,0.6813178062438965
1000_50_3,INVERSION,366,674,52,308,TRANSLOCATION,366,0,0.7549264430999756
1000_50_4,INVERSION,474,705,66,231,TRANSLOCATION,704,0,0.9676854610443115
1000_55_0,INVERSION,226,526,44,300,TRANSLOCATION,196,0,0.6948401927947998
1000_55_1,INVERSION,660,792,56,132,INVERSION,653,791,0.8313493728637695
1000_55_2,INVERSION,725,849,48,124,TRANSLOCATION,720,0,0.7269375324249268
1000_55_3,INVERSION,516,607,62,91,INVERSION,516,606,0.9398777484893799
1000_55_4,INVERSION,259,345,62,86,INVERSION,229,343,0.972766637802124
1000_60_0,INVERSION,445,690,43,245,INVERSION,445,721,0.6870632171630859
1000_60_1,INVERSION,454,618,64,164,INVERSION,455,616,0.9753594398498535
1000_60_2,INVERSION,763,1008,58,245,TRANSLOCATION,747,0,0.8771548271179199
1000_60_3,INVERSION,535,651,52,116,INVERSION,535,650,0.8010480403900146
1000_60_4,INVERSION,316,567,49,251,INVERSION,316,566,0.770334005355835
1000_65_0,INVERSION,540,628,38,88,INVERSION,498,562,0.6232089996337891
1000_65_1,INVERSION,563,737,37,174,TRANSLOCATION,531,0,0.5909569263458252
1000_65_2,INVERSION,382,710,60,328,INVERSION,334,709,0.9625990390777588
1000_65_3,INVERSION,255,383,42,128,INVERSION,255,282,0.6973855495452881
1000_65_4,INVERSION,453,724,52,271,INVERSION,453,734,0.8477516174316406
1000_70_0,INVERSION,567,804,56,237,INVERSION,564,802,0.9327991008758545
1000_70_1,INVERSION,738,919,47,181,TRANSLOCATION,738,0,0.7849338054656982
1000_70_2,INVERSION,379,692,37,313,INVERSION,380,690,0.6254496574401855
1000_70_3,INVERSION,489,636,39,147,INVERSION,490,634,0.6504096984863281
1000_70_4,INVERSION,445,608,50,163,INVERSION,446,606,0.8450689315795898
1000_75_0,INVERSION,667,919,39,252,TRANSLOCATION,667,0,0.6867959499359131
1000_75_1,INVERSION,701,820,30,119,INVERSION,784,719,0.5232343673706055
1000_75_2,INVERSION,752,1047,32,295,TRANSLOCATION,751,0,0.5495436191558838
1000_75_3,INVERSION,755,897,47,142,TRANSLOCATION,710,0,0.7996845245361328
1000_75_4,INVERSION,551,683,44,132,INVERSION,551,730,0.7650105953216553
1100_30_0,INVERSION,889,1236,100,347,TRANSLOCATION,877,0,1.3260655403137207
1100_30_1,INVERSION,136,298,94,162,INVERSION,136,297,1.2772116661071777
1100_30_2,INVERSION,762,924,125,162,TRANSLOCATION,928,0,1.61529541015625
1100_30_3,INVERSION,609,886,115,277,INVERSION,609,885,1.5057525634765625
1100_30_4,INVERSION,892,1144,126,252,TRANSLOCATION,892,0,1.6342597007751465
1100_35_0,INVERSION,343,498,119,155,INVERSION,343,497,1.6740574836730957
1100_35_1,INVERSION,844,919,83,75,INVERSION,831,917,1.127971887588501
1100_35_2,INVERSION,879,1010,96,131,TRANSLOCATION,879,0,1.337874174118042
1100_35_3,INVERSION,288,573,122,285,INVERSION,266,572,1.7193551063537598
1100_35_4,INVERSION,909,1020,96,111,TRANSLOCATION,909,0,1.3481755256652832
1100_40_0,INVERSION,261,389,69,128,INVERSION,251,388,1.024501085281372
1100_40_1,INVERSION,861,932,89,71,INVERSION,861,931,1.31276273727417
1100_40_2,INVERSION,573,779,75,206,INVERSION,574,777,1.0962367057800293
1100_40_3,INVERSION,131,488,90,357,TANDEM,487,118,1.336256980895996
1100_40_4,INVERSION,537,588,92,51,INVERSION,570,596,1.3568921089172363
1100_45_0,INVERSION,300,350,71,50,INVERSION,285,349,1.12178635597229
1100_45_1,INVERSION,569,873,63,304,INVERSION,569,872,0.9611315727233887
1100_45_2,INVERSION,652,780,79,128,INVERSION,653,778,1.2251622676849365
1100_45_3,INVERSION,619,908,89,289,INVERSION,606,906,1.378753423690796
1100_45_4,INVERSION,651,759,87,108,INVERSION,651,758,1.3419160842895508
1100_50_0,INVERSION,627,893,71,266,TRANSLOCATION,892,0,1.1444151401519775
1100_50_1,INVERSION,492,796,55,304,TRANSLOCATION,481,0,0.9063851833343506
1100_50_2,INVERSION,559,774,66,215,INVERSION,536,773,1.090254545211792
1100_50_3,INVERSION,795,1020,69,225,TRANSLOCATION,795,0,1.1355912685394287
1100_50_4,INVERSION,608,727,55,119,INVERSION,1100,1100,0.8996627330780029
1100_55_0,INVERSION,893,997,53,104,TRANSLOCATION,893,0,0.9154431819915771
1100_55_1,INVERSION,386,466,57,80,INVERSION,386,403,0.977832555770874
1100_55_2,INVERSION,274,468,50,194,TRANSLOCATION,274,0,0.8671364784240723
1100_55_3,INVERSION,881,1020,63,139,TRANSLOCATION,881,0,1.078209400177002
1100_55_4,INVERSION,401,533,46,132,INVERSION,369,532,0.8166956901550293
1100_60_0,INVERSION,555,685,49,130,INVERSION,555,684,0.8678350448608398
1100_60_1,INVERSION,428,723,56,295,INVERSION,428,722,1.0678706169128418
1100_60_2,INVERSION,861,996,43,135,TRANSLOCATION,861,0,0.8351855278015137
1100_60_3,INVERSION,275,488,45,213,TRANSLOCATION,487,0,0.8590812683105469
1100_60_4,INVERSION,858,1092,54,234,TRANSLOCATION,827,0,0.9834105968475342
1100_65_0,INVERSION,714,1007,39,293,TRANSLOCATION,714,0,0.7408127784729004
1100_65_1,INVERSION,600,807,51,207,INVERSION,582,806,1.008497714996338
1100_65_2,INVERSION,841,1134,52,293,TRANSLOCATION,801,0,1.0021047592163086
1100_65_3,INVERSION,430,540,36,110,INVERSION,430,459,0.7123677730560303
1100_65_4,INVERSION,325,486,41,161,INVERSION,325,523,0.813887357711792
1100_70_0,INVERSION,590,701,32,111,INVERSION,590,700,0.6600029468536377
1100_70_1,INVERSION,633,956,38,323,TRANSLOCATION,633,0,0.7369368076324463
1100_70_2,INVERSION,411,655,38,244,TRANSLOCATION,366,0,0.7518887519836426
1100_70_3,INVERSION,268,410,38,142,INVERSION,268,409,0.7540731430053711
1100_70_4,INVERSION,611,735,41,124,INVERSION,612,631,0.7927815914154053
1100_75_0,INVERSION,550,830,43,280,INVERSION,529,848,0.8790531158447266
1100_75_1,INVERSION,635,777,48,142,INVERSION,630,776,0.973360538482666
1100_75_2,INVERSION,462,781,34,319,TRANSLOCATION,447,0,0.7054815292358398
1100_75_3,INVERSION,365,483,31,118,INVERSION,366,401,0.6351356506347656
1100_75_4,INVERSION,455,616,32,161,INVERSION,455,615,0.6653501987457275
1200_30_0,INVERSION,669,911,113,242,INVERSION,669,910,1.6478796005249023
1200_30_1,INVERSION,384,553,147,169,INVERSION,385,551,2.177460193634033
1200_30_2,INVERSION,1051,1107,99,56,INVERSION,1051,1060,1.4375591278076172
1200_30_3,INVERSION,745,955,122,210,INVERSION,745,954,1.825681447982788
1200_30_4,INVERSION,660,911,89,251,TRANSLOCATION,660,0,1.295098066329956
1200_35_0,INVERSION,721,1087,121,366,TANDEM,1093,721,1.8968870639801025
1200_35_1,INVERSION,789,861,79,72,INVERSION,789,808,1.2392308712005615
1200_35_2,INVERSION,713,781,88,68,INVERSION,713,722,1.4038238525390625
1200_35_3,INVERSION,616,866,108,250,INVERSION,616,865,1.6913256645202637
1200_35_4,INVERSION,738,883,117,145,INVERSION,707,881,1.8203978538513184
1200_40_0,INVERSION,306,379,99,73,INVERSION,308,321,1.670494556427002
1200_40_1,INVERSION,877,1060,69,183,INVERSION,877,1059,1.165614366531372
1200_40_2,INVERSION,864,1017,95,153,INVERSION,864,1016,1.6060395240783691
1200_40_3,INVERSION,892,1150,78,258,TRANSLOCATION,892,0,1.296525001525879
1200_40_4,INVERSION,783,1114,79,331,TRANSLOCATION,783,0,1.31376051902771
1200_45_0,INVERSION,868,1169,74,301,TRANSLOCATION,844,0,1.3209373950958252
1200_45_1,INVERSION,400,614,55,214,INVERSION,400,613,0.9983158111572266
1200_45_2,INVERSION,727,832,77,105,INVERSION,727,831,1.3914635181427002
1200_45_3,INVERSION,1022,1342,79,320,TRANSLOCATION,1000,0,1.377439022064209
1200_45_4,INVERSION,668,947,74,279,INVERSION,668,946,1.302767276763916
1200_50_0,INVERSION,992,1060,55,68,INVERSION,993,1022,1.0249381065368652
1200_50_1,INVERSION,1002,1292,74,290,TRANSLOCATION,1002,0,1.3787055015563965
1200_50_2,INVERSION,756,1095,75,339,INVERSION,1200,1200,1.3876571655273438
1200_50_3,INVERSION,393,637,78,244,INVERSION,395,634,1.4678277969360352
1200_50_4,INVERSION,458,565,71,107,INVERSION,437,562,1.3357372283935547
1200_55_0,INVERSION,273,578,49,305,INVERSION,231,576,0.9839344024658203
1200_55_1,INVERSION,766,1062,59,296,TRANSLOCATION,766,0,1.1681592464447021
1200_55_2,INVERSION,605,974,70,369,INVERSION,574,973,1.3602116107940674
1200_55_3,INVERSION,934,1031,67,97,INVERSION,934,963,1.3082656860351562
1200_55_4,INVERSION,395,604,66,209,INVERSION,395,603,1.2921035289764404
1200_60_0,INVERSION,645,866,57,221,INVERSION,604,865,1.1839876174926758
1200_60_1,INVERSION,779,950,41,171,INVERSION,734,949,0.8612985610961914
1200_60_2,INVERSION,544,659,44,115,INVERSION,544,563,0.9275784492492676
1200_60_3,INVERSION,985,1128,44,143,INVERSION,1200,1200,0.9028594493865967
1200_60_4,INVERSION,226,485,72,259,INVERSION,198,514,1.551290512084961
1200_65_0,INVERSION,527,675,41,148,INVERSION,492,674,0.9344227313995361
1200_65_1,INVERSION,631,858,62,227,INVERSION,594,857,1.3766233921051025
1200_65_2,INVERSION,273,361,52,88,INVERSION,273,360,1.1678617000579834
1200_65_3,INVERSION,795,1135,50,340,TRANSLOCATION,793,0,1.1131465435028076
1200_65_4,INVERSION,826,1097,39,271,INVERSION,1200,1200,0.8504798412322998
1200_70_0,INVERSION,680,817,53,137,INVERSION,652,815,1.1876740455627441
1200_70_1,INVERSION,299,653,40,354,INVERSION,299,699,0.9152514934539795
1200_70_2,INVERSION,840,1128,46,288,TRANSLOCATION,840,0,1.02522873878479
1200_70_3,INVERSION,448,679,38,231,TRANSLOCATION,448,0,0.8738739490509033
1200_70_4,INVERSION,274,433,46,159,INVERSION,274,443,1.0606269836425781
1200_75_0,INVERSION,793,938,47,145,INVERSION,794,830,1.0823051929473877
1200_75_1,INVERSION,492,886,37,394,INVERSION,464,940,0.8794369697570801
1200_75_2,INVERSION,797,1034,47,237,TRANSLOCATION,791,0,1.085144281387329
1200_75_3,INVERSION,464,557,48,93,INVERSION,464,556,1.1403577327728271
1200_75_4,INVERSION,530,875,32,345,INVERSION,530,902,0.763577938079834
1300_30_0,INVERSION,565,749,119,184,INVERSION,557,748,2.0041677951812744
1300_30_1,INVERSION,892,1181,131,289,TANDEM,1179,893,2.160493850708008
1300_30_2,INVERSION,920,1310,101,390,TRANSLOCATION,920,0,1.695937156677246
1300_30_3,INVERSION,1029,1414,128,385,TRANSLOCATION,1009,0,2.14131236076355
1300_30_4,INVERSION,1103,1237,109,134,TRANSLOCATION,1105,0,1.825542688369751
1300_35_0,INVERSION,401,502,93,101,INVERSION,392,520,1.6368892192840576
1300_35_1,INVERSION,893,988,104,95,INVERSION,869,992,1.8611228466033936
1300_35_2,INVERSION,509,826,90,317,INVERSION,499,825,1.5555949211120605
1300_35_3,INVERSION,436,792,93,356,INVERSION,433,791,1.6439881324768066
1300_35_4,INVERSION,1095,1277,89,182,TRANSLOCATION,1095,0,1.5174455642700195
1300_40_0,INVERSION,733,907,101,174,INVERSION,733,906,1.8658523559570312
1300_40_1,INVERSION,983,1050,73,67,INVERSION,983,996,1.4073741436004639
1300_40_2,INVERSION,654,728,97,74,INVERSION,655,751,1.847362756729126
1300_40_3,INVERSION,805,972,66,167,INVERSION,799,971,1.2484073638916016
1300_40_4,INVERSION,460,755,74,295,INVERSION,429,778,1.3950684070587158
1300_45_0,INVERSION,542,639,59,97,INVERSION,542,566,1.2033054828643799
1300_45_1,INVERSION,1079,1375,63,296,TANDEM,1300,1300,1.2534754276275635
1300_45_2,INVERSION,400,585,74,185,INVERSION,400,584,1.4851431846618652
1300_45_3,INVERSION,869,1245,67,376,TRANSLOCATION,869,0,1.353924036026001
1300_45_4,INVERSION,574,829,87,255,INVERSION,574,828,1.756293773651123
1300_50_0,INVERSION,688,944,82,256,INVERSION,681,943,1.7560203075408936
1300_50_1,INVERSION,530,920,57,390,INVERSION,532,917,1.2084546089172363
1300_50_2,INVERSION,1103,1190,54,87,INVERSION,1300,1300,1.1644213199615479
1300_50_3,INVERSION,682,799,67,117,INVERSION,682,798,1.4604825973510742
1300_50_4,INVERSION,1097,1330,81,233,TRANSLOCATION,1086,0,1.761423110961914
1300_55_0,INVERSION,1042,1395,48,353,TRANSLOCATION,1042,0,1.0695364475250244
1300_55_1,INVERSION,384,506,68,122,INVERSION,329,505,1.554478645324707
1300_55_2,INVERSION,355,774,73,419,INVERSION,318,772,1.6632165908813477
1300_55_3,INVERSION,360,701,75,341,INVERSION,310,700,1.6643805503845215
1300_55_4,INVERSION,824,1201,77,377,TRANSLOCATION,824,0,1.6993625164031982
1300_60_0,INVERSION,426,717,50,291,INVERSION,427,715,1.1799566745758057
1300_60_1,INVERSION,762,1037,47,275,INVERSION,762,1036,1.103271722793579
1300_60_2,INVERSION,341,732,59,391,INVERSION,342,730,1.3901324272155762
1300_60_3,INVERSION,299,415,67,116,INVERSION,300,337,1.5947074890136719
1300_60_4,INVERSION,331,485,65,154,INVERSION,282,511,1.5690083503723145
1300_65_0,INVERSION,341,548,41,207,INVERSION,341,547,1.0361976623535156
1300_65_1,INVERSION,497,904,33,407,INVERSION,499,960,0.795093297958374
1300_65_2,INVERSION,327,635,53,308,INVERSION,273,634,1.3299570083618164
1300_65_3,INVERSION,829,1180,50,351,TRANSLOCATION,829,0,1.2346627712249756
1300_65_4,INVERSION,466,882,38,416,INVERSION,435,881,0.9839136600494385
1300_70_0,INVERSION,940,1166,42,226,INVERSION,1300,1300,1.0944206714630127
1300_70_1,INVERSION,751,862,55,111,INVERSION,751,783,1.44576096534729
1300_70_2,INVERSION,468,775,34,307,INVERSION,445,774,0.9171547889709473
1300_70_3,INVERSION,899,1188,51,289,TRANSLOCATION,899,0,1.3087761402130127
1300_70_4,INVERSION,624,1048,37,424,TRANSLOCATION,626,0,0.9964807033538818
1300_75_0,INVERSION,601,884,38,283,TRANSLOCATION,601,0,1.047346830368042
1300_75_1,INVERSION,866,1117,43,251,TRANSLOCATION,863,0,1.1603941917419434
1300_75_2,INVERSION,333,730,44,397,INVERSION,336,726,1.2258057594299316
1300_75_3,INVERSION,806,956,37,150,INVERSION,802,955,1.0100176334381104
1300_75_4,INVERSION,745,1080,45,335,INVERSION,694,1079,1.2184855937957764
1400_30_0,INVERSION,310,445,118,135,TRANSLOCATION,444,0,2.2574212551116943
1400_30_1,INVERSION,820,1079,105,259,INVERSION,820,1078,1.9683613777160645
1400_30_2,INVERSION,453,767,103,314,TRANSLOCATION,777,0,1.976426124572754
1400_30_3,INVERSION,1108,1537,96,429,TRANSLOCATION,1110,0,1.8198390007019043
1400_30_4,INVERSION,325,463,129,138,INVERSION,306,461,2.4649810791015625
1400_35_0,INVERSION,732,830,97,98,INVERSION,724,829,2.0061869621276855
1400_35_1,INVERSION,512,621,135,109,INVERSION,504,632,2.7793638706207275
1400_35_2,INVERSION,506,927,92,421,TANDEM,926,486,1.8311998844146729
1400_35_3,INVERSION,228,485,96,257,INVERSION,204,480,1.9713475704193115
1400_35_4,INVERSION,693,969,86,276,INVERSION,665,966,1.7502515316009521
1400_40_0,INVERSION,880,1259,91,379,TRANSLOCATION,881,0,1.987783670425415
1400_40_1,INVERSION,439,598,75,159,INVERSION,439,597,1.636678695678711
1400_40_2,INVERSION,1234,1491,71,257,TRANSLOCATION,1211,0,1.5196964740753174
1400_40_3,INVERSION,998,1379,88,381,TRANSLOCATION,965,0,1.8804616928100586
1400_40_4,INVERSION,1238,1344,78,106,TRANSLOCATION,1239,0,1.655461072921753
1400_45_0,INVERSION,856,1251,56,395,TRANSLOCATION,856,0,1.3067800998687744
1400_45_1,INVERSION,739,826,74,87,INVERSION,740,824,1.7179474830627441
1400_45_2,INVERSION,1147,1431,64,284,TRANSLOCATION,1147,0,1.4522101879119873
1400_45_3,INVERSION,298,401,81,103,INVERSION,298,400,1.893043041229248
1400_45_4,INVERSION,813,915,63,102,INVERSION,762,837,1.4520611763000488
1400_50_0,INVERSION,820,1157,66,337,INVERSION,793,1156,1.5863146781921387
1400_50_1,INVERSION,770,890,59,120,TRANSLOCATION,745,0,1.445892572402954
1400_50_2,INVERSION,728,916,63,188,INVERSION,703,924,1.573850393295288
1400_50_3,INVERSION,387,604,66,217,INVERSION,387,603,1.5997645854949951
1400_50_4,INVERSION,292,750,54,458,INVERSION,292,749,1.306483507156372
1400_55_0,INVERSION,343,803,53,460,INVERSION,295,802,1.3759174346923828
1400_55_1,INVERSION,1201,1365,67,164,TRANSLOCATION,1164,0,1.6720402240753174
1400_55_2,INVERSION,324,660,54,336,INVERSION,324,659,1.4258148670196533
1400_55_3,INVERSION,430,876,51,446,INVERSION,431,874,1.317814826965332
1400_55_4,INVERSION,231,403,68,172,INVERSION,231,412,1.794412612915039
1400_60_0,INVERSION,894,1022,41,128,INVERSION,896,1021,1.135390043258667
1400_60_1,INVERSION,813,1232,52,419,TRANSLOCATION,815,0,1.3858375549316406
1400_60_2,INVERSION,1011,1447,63,436,TRANSLOCATION,1011,0,1.682114839553833
1400_60_3,INVERSION,484,752,48,268,INVERSION,456,751,1.3173353672027588
1400_60_4,INVERSION,789,1124,57,335,INVERSION,789,1142,1.5462167263031006
1400_65_0,INVERSION,877,1251,41,374,INVERSION,1400,1400,1.1552305221557617
1400_65_1,INVERSION,718,977,41,259,INVERSION,718,976,1.1467642784118652
1400_65_2,INVERSION,1083,1330,36,247,TRANSLOCATION,1017,0,1.0060646533966064
1400_65_3,INVERSION,1060,1159,43,99,INVERSION,1060,1087,1.2177050113677979
1400_65_4,INVERSION,553,930,49,377,INVERSION,504,929,1.3928115367889404
1400_70_0,INVERSION,1072,1268,37,196,TRANSLOCATION,1062,0,1.0933520793914795
1400_70_1,INVERSION,578,988,50,410,INVERSION,578,1053,1.501929759979248
1400_70_2,INVERSION,367,553,38,186,TRANSLOCATION,367,0,1.158987283706665
1400_70_3,INVERSION,625,990,42,365,INVERSION,625,989,1.2559971809387207
1400_70_4,INVERSION,862,1000,50,138,INVERSION,826,901,1.4738216400146484
1400_75_0,INVERSION,649,1083,35,434,INVERSION,602,1090,1.0652797222137451
1400_75_1,INVERSION,909,1320,39,411,TRANSLOCATION,851,0,1.2246243953704834
1400_75_2,INVERSION,1083,1188,38,105,INVERSION,1083,1132,1.1755859851837158
1400_75_3,INVERSION,584,759,39,175,INVERSION,584,803,1.2092335224151611
1400_75_4,INVERSION,880,1104,45,224,INVERSION,880,1103,1.3652455806732178
1500_30_0,INVERSION,1313,1559,92,246,TRANSLOCATION,1313,0,1.9174978733062744
1500_30_1,INVERSION,1051,1223,90,172,TRANSLOCATION,1222,0,1.9019358158111572
1500_30_2,INVERSION,475,634,165,159,INVERSION,475,633,3.4883508682250977
1500_30_3,INVERSION,534,852,149,318,TANDEM,867,534,3.075218439102173
1500_30_4,INVERSION,706,1091,100,385,TANDEM,1106,706,2.097412586212158
1500_35_0,INVERSION,971,1161,85,190,INVERSION,949,1160,1.9379143714904785
1500_35_1,INVERSION,1268,1564,75,296,TRANSLOCATION,1246,0,1.6975369453430176
1500_35_2,INVERSION,626,1052,70,426,TRANSLOCATION,1051,0,1.5565083026885986
1500_35_3,INVERSION,164,291,122,127,INVERSION,165,289,2.744763135910034
1500_35_4,INVERSION,1169,1552,101,383,TRANSLOCATION,1170,0,2.2660701274871826
1500_40_0,INVERSION,1283,1575,79,292,TRANSLOCATION,1245,0,1.8900322914123535
1500_40_1,INVERSION,1139,1524,72,385,TRANSLOCATION,1139,0,1.7469394207000732
1500_40_2,INVERSION,1233,1716,72,483,TRANSLOCATION,1207,0,1.7229053974151611
1500_40_3,INVERSION,718,790,76,72,INVERSION,681,789,1.8400657176971436
1500_40_4,INVERSION,978,1348,64,370,TRANSLOCATION,980,0,1.5402097702026367
1500_45_0,INVERSION,850,1023,61,173,INVERSION,850,1028,1.573760986328125
1500_45_1,INVERSION,717,970,90,253,INVERSION,719,989,2.2693910598754883
1500_45_2,INVERSION,271,596,60,325,INVERSION,221,595,1.5302722454071045
1500_45_3,INVERSION,637,1114,70,477,TANDEM,1135,626,1.765364408493042
1500_45_4,INVERSION,942,1197,87,255,INVERSION,942,1196,2.227792739868164
1500_50_0,INVERSION,1273,1376,63,103,TRANSLOCATION,1273,0,1.6999139785766602
1500_50_1,INVERSION,736,971,49,235,TRANSLOCATION,738,0,1.3497323989868164
1500_50_2,INVERSION,727,1219,73,492,TRANSLOCATION,729,0,1.9986917972564697
1500_50_3,INVERSION,1303,1402,55,99,INVERSION,1500,1500,1.4797635078430176
1500_50_4,INVERSION,287,646,57,359,INVERSION,287,645,1.6034276485443115
1500_55_0,INVERSION,1091,1283,67,192,TRANSLOCATION,1025,0,1.9308278560638428
1500_55_1,INVERSION,832,1113,70,281,INVERSION,815,1112,2.0692529678344727
1500_55_2,INVERSION,653,740,55,87,INVERSION,606,691,1.641000747680664
1500_55_3,INVERSION,426,614,61,188,INVERSION,381,613,1.7413268089294434
1500_55_4,INVERSION,342,577,64,235,INVERSION,342,576,1.8768987655639648
1500_60_0,INVERSION,826,1236,38,410,TRANSLOCATION,828,0,1.124936580657959
1500_60_1,INVERSION,901,1357,52,456,TRANSLOCATION,901,0,1.5783205032348633
1500_60_2,INVERSION,784,1026,58,242,INVERSION,725,1025,1.7463116645812988
1500_60_3,INVERSION,549,684,41,135,INVERSION,649,587,1.2446753978729248
1500_60_4,INVERSION,1254,1666,63,412,TRANSLOCATION,1254,0,1.8710217475891113
1500_65_0,INVERSION,662,878,52,216,INVERSION,664,918,1.6664528846740723
1500_65_1,INVERSION,1122,1465,66,343,TRANSLOCATION,1122,0,2.047947406768799
1500_65_2,INVERSION,662,786,45,124,INVERSION,621,703,1.4237563610076904
1500_65_3,INVERSION,723,1192,47,469,INVERSION,703,1208,1.4727861881256104
1500_65_4,INVERSION,457,920,36,463,TRANSLOCATION,458,0,1.1600227355957031
1500_70_0,INVERSION,721,895,46,174,INVERSION,678,894,1.5523173809051514
1500_70_1,INVERSION,332,468,55,136,INVERSION,308,467,1.8348119258880615
1500_70_2,INVERSION,629,1077,39,448,INVERSION,595,1128,1.296083927154541
1500_70_3,INVERSION,1000,1441,35,441,TRANSLOCATION,959,0,1.1636900901794434
1500_70_4,INVERSION,647,1079,40,432,TRANSLOCATION,577,0,1.319138526916504
1500_75_0,INVERSION,1006,1426,32,420,TRANSLOCATION,1007,0,1.0938024520874023
1500_75_1,INVERSION,1010,1156,32,146,INVERSION,1010,1155,1.0895628929138184
1500_75_2,INVERSION,876,1013,47,137,INVERSION,876,926,1.6412684917449951
1500_75_3,INVERSION,1136,1250,43,114,INVERSION,1087,1291,1.4838931560516357
1500_75_4,INVERSION,711,1025,30,314,INVERSION,633,1067,1.0714788436889648
1600_30_0,INVERSION,371,743,95,372,INVERSION,350,755,2.162480115890503
1600_30_1,INVERSION,806,1091,127,285,INVERSION,796,1088,2.9441704750061035
1600_30_2,INVERSION,655,853,97,198,TRANSLOCATION,871,0,2.2786033153533936
1600_30_3,INVERSION,145,280,133,135,INVERSION,115,279,3.06046986579895
1600_30_4,INVERSION,300,690,100,390,TANDEM,715,281,2.306378126144409
1600_35_0,INVERSION,1379,1808,83,429,TRANSLOCATION,1348,0,2.062014102935791
1600_35_1,INVERSION,1103,1441,120,338,INVERSION,1091,1468,2.9752485752105713
1600_35_2,INVERSION,1210,1365,121,155,INVERSION,1210,1364,2.9284965991973877
1600_35_3,INVERSION,738,904,82,166,INVERSION,700,913,2.071972131729126
1600_35_4,INVERSION,827,1000,71,173,TRANSLOCATION,827,0,1.775390625
1600_40_0,INVERSION,317,521,66,204,INVERSION,274,520,1.786677598953247
1600_40_1,INVERSION,503,575,67,72,INVERSION,503,520,1.7798340320587158
1600_40_2,INVERSION,916,1123,76,207,TRANSLOCATION,1121,0,2.027702808380127
1600_40_3,INVERSION,516,657,108,141,INVERSION,488,551,2.8963916301727295
1600_40_4,INVERSION,242,475,74,233,INVERSION,242,474,1.9893107414245605
1600_45_0,INVERSION,501,1030,77,529,INVERSION,501,1029,2.1665682792663574
1600_45_1,INVERSION,425,565,57,140,INVERSION,425,564,1.6272234916687012
1600_45_2,INVERSION,658,787,58,129,INVERSION,658,786,1.6548500061035156
1600_45_3,INVERSION,360,466,63,106,INVERSION,321,476,1.824876308441162
1600_45_4,INVERSION,458,574,64,116,INVERSION,454,477,1.8388874530792236
1600_50_0,INVERSION,667,1059,59,392,INVERSION,651,1058,1.767249584197998
1600_50_1,INVERSION,786,1052,81,266,INVERSION,786,1051,2.4379525184631348
1600_50_2,INVERSION,720,952,57,232,INVERSION,720,992,1.7326643466949463
1600_50_3,INVERSION,1052,1222,73,170,INVERSION,1007,1272,2.2030584812164307
1600_50_4,INVERSION,618,738,82,120,INVERSION,617,737,2.434305429458618
1600_55_0,INVERSION,1194,1357,61,163,INVERSION,1196,1354,1.937819480895996
1600_55_1,INVERSION,1204,1352,57,148,INVERSION,1154,1350,1.8088555335998535
1600_55_2,INVERSION,468,866,63,398,INVERSION,468,865,2.0576374530792236
1600_55_3,INVERSION,410,796,52,386,INVERSION,410,795,1.6765098571777344
1600_55_4,INVERSION,551,761,48,210,INVERSION,552,759,1.5561251640319824
1600_60_0,INVERSION,725,1130,46,405,INVERSION,672,1129,1.5777719020843506
1600_60_1,INVERSION,416,791,76,375,INVERSION,416,790,2.594313859939575
1600_60_2,INVERSION,812,1259,55,447,INVERSION,813,1324,1.8123245239257812
1600_60_3,INVERSION,725,1171,40,446,INVERSION,689,1170,1.344508409500122
1600_60_4,INVERSION,1102,1334,56,232,INVERSION,1079,1367,1.879913568496704
1600_65_0,INVERSION,583,867,60,284,INVERSION,523,866,2.1355061531066895
1600_65_1,INVERSION,422,568,39,146,INVERSION,361,567,1.4163146018981934
1600_65_2,INVERSION,735,974,43,239,INVERSION,735,973,1.505486011505127
1600_65_3,INVERSION,1195,1344,63,149,INVERSION,1183,1376,2.215235948562622
1600_65_4,INVERSION,510,703,50,193,INVERSION,510,557,1.7904510498046875
1600_70_0,INVERSION,1047,1564,35,517,TRANSLOCATION,974,0,1.3035831451416016
1600_70_1,INVERSION,674,1072,49,398,INVERSION,660,1112,1.8155512809753418
1600_70_2,INVERSION,735,1177,56,442,INVERSION,735,1176,2.097783327102661
1600_70_3,INVERSION,614,1128,48,514,INVERSION,544,1127,1.7763080596923828
1600_70_4,INVERSION,861,1089,46,228,INVERSION,852,894,1.7163681983947754
1600_75_0,INVERSION,906,1299,31,393,INVERSION,876,1332,1.1975460052490234
1600_75_1,INVERSION,773,982,41,209,INVERSION,773,817,1.5952482223510742
1600_75_2,INVERSION,539,962,35,423,INVERSION,477,1036,1.356968879699707
1600_75_3,INVERSION,1185,1321,31,136,INVERSION,1141,1223,1.1902194023132324
1600_75_4,INVERSION,428,650,29,222,INVERSION,428,464,1.1510677337646484
1700_30_0,INVERSION,1429,1826,158,397,TRANSLOCATION,1429,0,3.911857843399048
1700_30_1,INVERSION,441,637,146,196,INVERSION,410,636,3.644705295562744
1700_30_2,INVERSION,1247,1794,120,547,TRANSLOCATION,1237,0,3.0534534454345703
1700_30_3,INVERSION,1166,1294,123,128,INVERSION,1166,1293,3.1055541038513184
1700_30_4,INVERSION,1415,1823,88,408,TANDEM,1700,1700,2.212480306625366
1700_35_0,INVERSION,749,1001,90,252,INVERSION,734,1000,2.452155351638794
1700_35_1,INVERSION,703,816,109,113,INVERSION,675,814,2.9559595584869385
1700_35_2,INVERSION,200,663,122,463,TANDEM,662,191,3.367335081100464
1700_35_3,INVERSION,1055,1562,96,507,TRANSLOCATION,1055,0,2.631969928741455
1700_35_4,INVERSION,1065,1269,74,204,TRANSLOCATION,1268,0,1.9831514358520508
1700_40_0,INVERSION,454,631,90,177,INVERSION,454,630,2.6179709434509277
1700_40_1,INVERSION,1239,1653,75,414,TRANSLOCATION,1239,0,2.195019245147705
1700_40_2,INVERSION,330,729,79,399,INVERSION,330,728,2.3239736557006836
1700_40_3,INVERSION,524,981,69,457,INVERSION,518,980,2.032728672027588
1700_40_4,INVERSION,1307,1454,96,147,INVERSION,1307,1453,2.8128771781921387
1700_45_0,INVERSION,854,1181,63,327,INVERSION,814,1189,1.9494216442108154
1700_45_1,INVERSION,1411,1520,73,109,INVERSION,1411,1427,2.2675979137420654
1700_45_2,INVERSION,957,1467,78,510,INVERSION,945,1469,2.4419026374816895
1700_45_3,INVERSION,1470,1923,94,453,TRANSLOCATION,1470,0,2.9087681770324707
1700_45_4,INVERSION,242,420,65,178,INVERSION,242,419,2.072812557220459
1700_50_0,INVERSION,324,577,91,253,INVERSION,324,576,3.0412838459014893
1700_50_1,INVERSION,1013,1448,61,435,INVERSION,1013,1447,1.999790906906128
1700_50_2,INVERSION,1429,1906,79,477,TRANSLOCATION,1390,0,2.58207368850708
1700_50_3,INVERSION,469,1030,61,561,INVERSION,470,1037,2.0488340854644775
1700_50_4,INVERSION,923,1149,74,226,INVERSION,890,1148,2.4689934253692627
1700_55_0,INVERSION,926,1440,50,514,INVERSION,926,1439,1.783151388168335
1700_55_1,INVERSION,1201,1303,59,102,INVERSION,1258,1232,2.0560920238494873
1700_55_2,INVERSION,658,864,53,206,TRANSLOCATION,659,0,1.888507604598999
1700_55_3,INVERSION,1318,1612,48,294,TRANSLOCATION,1249,0,1.6836450099945068
1700_55_4,INVERSION,294,486,56,192,INVERSION,263,506,2.057560443878174
1700_60_0,INVERSION,359,506,42,147,INVERSION,311,379,1.5896697044372559
1700_60_1,INVERSION,459,659,58,200,INVERSION,461,656,2.1858785152435303
1700_60_2,INVERSION,660,1133,55,473,INVERSION,599,1132,2.0681064128875732
1700_60_3,INVERSION,1146,1352,53,206,INVERSION,1147,1350,1.9662330150604248
1700_60_4,INVERSION,312,433,55,121,INVERSION,295,432,2.0760676860809326
1700_65_0,INVERSION,1205,1567,33,362,TRANSLOCATION,1205,0,1.2769877910614014
1700_65_1,INVERSION,909,1460,58,551,TRANSLOCATION,903,0,2.2431352138519287
1700_65_2,INVERSION,1090,1343,40,253,TRANSLOCATION,1342,0,1.574845314025879
1700_65_3,INVERSION,421,907,35,486,INVERSION,421,906,1.3876757621765137
1700_65_4,INVERSION,1179,1654,52,475,TRANSLOCATION,1164,0,2.0450594425201416
1700_70_0,INVERSION,1294,1518,47,224,INVERSION,1274,1355,1.896193265914917
1700_70_1,INVERSION,871,1208,58,337,INVERSION,869,1225,2.3819494247436523
1700_70_2,INVERSION,476,737,33,261,TRANSLOCATION,449,0,1.3836288452148438
1700_70_3,INVERSION,973,1101,34,128,INVERSION,974,1015,1.4227759838104248
1700_70_4,INVERSION,1051,1405,45,354,TRANSLOCATION,1052,0,1.8383073806762695
1700_75_0,INVERSION,936,1354,38,418,INVERSION,851,1353,1.6341910362243652
1700_75_1,INVERSION,1175,1521,40,346,TRANSLOCATION,1175,0,1.6955573558807373
1700_75_2,INVERSION,559,856,32,297,TRANSLOCATION,507,0,1.3773698806762695
1700_75_3,INVERSION,764,1282,43,518,INVERSION,764,1281,1.8908798694610596
1700_75_4,INVERSION,771,1287,33,516,INVERSION,771,1372,1.4568994045257568
1800_30_0,INVERSION,1443,1744,100,301,TRANSLOCATION,1444,0,2.7247495651245117
1800_30_1,INVERSION,660,860,100,200,INVERSION,662,857,2.7521634101867676
1800_30_2,INVERSION,980,1201,161,221,INVERSION,980,1200,4.382338285446167
1800_30_3,INVERSION,202,713,109,511,TANDEM,712,202,3.0007176399230957
1800_30_4,INVERSION,1595,1779,136,184,TRANSLOCATION,1595,0,3.7600207328796387
1800_35_0,INVERSION,1066,1272,100,206,INVERSION,1066,1271,3.00748872756958
1800_35_1,INVERSION,269,839,75,570,INVERSION,269,861,2.1976733207702637
1800_35_2,INVERSION,572,924,87,352,INVERSION,553,923,2.6316826343536377
1800_35_3,INVERSION,815,1285,100,470,INVERSION,815,1284,2.972470998764038
1800_35_4,INVERSION,1130,1641,111,511,TRANSLOCATION,1114,0,3.259215831756592
1800_40_0,INVERSION,300,409,82,109,INVERSION,372,338,2.645754337310791
1800_40_1,INVERSION,1572,2078,81,506,TRANSLOCATION,1572,0,2.5962865352630615
1800_40_2,INVERSION,399,572,100,173,INVERSION,391,571,3.235069990158081
1800_40_3,INVERSION,333,739,70,406,INVERSION,333,762,2.2512733936309814
1800_40_4,INVERSION,1390,1906,103,516,TRANSLOCATION,1390,0,3.2618887424468994
1800_45_0,INVERSION,1092,1539,71,447,INVERSION,1092,1584,2.4409961700439453
1800_45_1,INVERSION,664,787,74,123,INVERSION,752,691,2.5424399375915527
1800_45_2,INVERSION,983,1459,63,476,TRANSLOCATION,1458,0,2.2236251831054688
1800_45_3,INVERSION,1352,1664,96,312,TRANSLOCATION,1296,0,3.2427213191986084
1800_45_4,INVERSION,687,810,88,123,INVERSION,687,722,3.1115176677703857
1800_50_0,INVERSION,614,705,49,91,INVERSION,571,636,1.8130834102630615
1800_50_1,INVERSION,1156,1268,51,112,INVERSION,1156,1183,1.8720769882202148
1800_50_2,INVERSION,1355,1936,79,581,TRANSLOCATION,1302,0,2.8481383323669434
1800_50_3,INVERSION,1073,1528,77,455,INVERSION,1062,1527,2.7748489379882812
1800_50_4,INVERSION,798,1190,48,392,INVERSION,789,1215,1.7781810760498047
1800_55_0,INVERSION,674,1086,63,412,INVERSION,660,1109,2.4863996505737305
1800_55_1,INVERSION,737,921,55,184,TRANSLOCATION,737,0,2.119854211807251
1800_55_2,INVERSION,1053,1465,58,412,INVERSION,1002,1463,2.2242603302001953
1800_55_3,INVERSION,358,598,45,240,INVERSION,359,596,1.7770307064056396
1800_55_4,INVERSION,584,1078,61,494,INVERSION,570,1116,2.3816640377044678
1800_60_0,INVERSION,530,1029,42,499,TRANSLOCATION,1026,0,1.7146916389465332
1800_60_1,INVERSION,1163,1586,46,423,TRANSLOCATION,1129,0,1.8474745750427246
1800_60_2,INVERSION,543,655,45,112,INVERSION,516,583,1.8893029689788818
1800_60_3,INVERSION,1051,1610,46,559,TRANSLOCATION,995,0,1.8860628604888916
1800_60_4,INVERSION,531,798,55,267,INVERSION,532,857,2.2788808345794678
1800_65_0,INVERSION,603,878,48,275,INVERSION,604,876,2.0849685668945312
1800_65_1,INVERSION,699,883,41,184,INVERSION,667,723,1.793898582458496
1800_65_2,INVERSION,1009,1335,38,326,INVERSION,984,1334,1.651942491531372
1800_65_3,INVERSION,1148,1323,51,175,INVERSION,1125,1322,2.158118724822998
1800_65_4,INVERSION,466,670,54,204,INVERSION,633,502,2.3551242351531982
1800_70_0,INVERSION,1302,1632,52,330,TRANSLOCATION,1302,0,2.3624062538146973
1800_70_1,INVERSION,913,1248,65,335,INVERSION,913,1247,2.9258437156677246
1800_70_2,INVERSION,1193,1394,45,201,INVERSION,1193,1473,2.0320310592651367
1800_70_3,INVERSION,836,1195,40,359,INVERSION,796,1237,1.820300579071045
1800_70_4,INVERSION,351,642,40,291,INVERSION,295,662,1.8398711681365967
1800_75_0,INVERSION,1195,1776,42,581,TRANSLOCATION,1148,0,1.9735057353973389
1800_75_1,INVERSION,908,1212,29,304,INVERSION,908,1211,1.411482334136963
1800_75_2,INVERSION,956,1530,39,574,TRANSLOCATION,899,0,1.8366503715515137
1800_75_3,INVERSION,1056,1423,41,367,INVERSION,1057,1421,1.966672658920288
1800_75_4,INVERSION,1126,1692,47,566,TRANSLOCATION,1055,0,2.248875379562378
1900_30_0,INVERSION,1728,1987,101,259,TRANSLOCATION,1729,0,2.999891757965088
1900_30_1,INVERSION,1572,2166,86,594,TANDEM,1900,1900,2.557053565979004
1900_30_2,INVERSION,563,1151,100,588,TRANSLOCATION,563,0,3.018139362335205
1900_30_3,INVERSION,553,861,128,308,INVERSION,553,860,3.8966128826141357
1900_30_4,INVERSION,546,779,103,233,INVERSION,546,778,3.113513946533203
1900_35_0,INVERSION,1652,1766,86,114,TRANSLOCATION,1643,0,2.7052156925201416
1900_35_1,INVERSION,724,802,90,78,INVERSION,724,832,2.91145658493042
1900_35_2,INVERSION,1356,1622,115,266,INVERSION,1352,1621,3.673340320587158
1900_35_3,INVERSION,508,691,98,183,INVERSION,470,722,3.2096974849700928
1900_35_4,INVERSION,720,1316,100,596,TANDEM,1315,720,3.222628116607666
1900_40_0,INVERSION,1339,1736,98,397,TRANSLOCATION,1339,0,3.406050443649292
1900_40_1,INVERSION,555,659,76,104,INVERSION,555,583,2.6965787410736084
1900_40_2,INVERSION,991,1213,72,222,TRANSLOCATION,991,0,2.4838356971740723
1900_40_3,INVERSION,345,806,69,461,TRANSLOCATION,347,0,2.4405386447906494
1900_40_4,INVERSION,1239,1778,70,539,TRANSLOCATION,1239,0,2.4748542308807373
1900_45_0,INVERSION,764,1238,66,474,INVERSION,721,1287,2.4565064907073975
1900_45_1,INVERSION,1102,1475,72,373,INVERSION,1062,1488,2.6732585430145264
1900_45_2,INVERSION,675,1176,79,501,INVERSION,678,1172,2.9618709087371826
1900_45_3,INVERSION,878,1241,78,363,INVERSION,840,1259,2.889941453933716
1900_45_4,INVERSION,542,1125,79,583,INVERSION,516,1124,2.938913583755493
1900_50_0,INVERSION,566,944,74,378,INVERSION,514,943,2.9757015705108643
1900_50_1,INVERSION,1080,1693,64,613,TRANSLOCATION,1037,0,2.5782155990600586
1900_50_2,INVERSION,931,1346,50,415,INVERSION,932,1343,1.992548942565918
1900_50_3,INVERSION,629,881,72,252,INVERSION,616,887,2.8690314292907715
1900_50_4,INVERSION,851,1006,54,155,INVERSION,851,1030,2.144118070602417
1900_55_0,INVERSION,1060,1635,78,575,TRANSLOCATION,991,0,3.249579906463623
1900_55_1,INVERSION,629,1240,55,611,INVERSION,625,1238,2.357558250427246
1900_55_2,INVERSION,307,865,78,558,INVERSION,307,863,3.4302144050598145
1900_55_3,INVERSION,1310,1437,50,127,INVERSION,1310,1341,2.109956979751587
1900_55_4,INVERSION,470,786,61,316,INVERSION,428,784,2.581861734390259
1900_60_0,INVERSION,1103,1573,54,470,INVERSION,1103,1590,2.4443185329437256
1900_60_1,INVERSION,461,800,43,339,INVERSION,412,798,1.9478306770324707
1900_60_2,INVERSION,743,1132,46,389,INVERSION,743,1131,2.0537829399108887
1900_60_3,INVERSION,527,1091,39,564,INVERSION,445,1157,1.756244421005249
1900_60_4,INVERSION,995,1541,55,546,INVERSION,967,1594,2.473217487335205
1900_65_0,INVERSION,1352,1708,42,356,TRANSLOCATION,1352,0,1.9428009986877441
1900_65_1,INVERSION,616,919,43,303,INVERSION,602,973,2.0542564392089844
1900_65_2,INVERSION,821,1116,38,295,INVERSION,821,1115,1.787950038909912
1900_65_3,INVERSION,542,1048,39,506,INVERSION,542,1047,1.8778300285339355
1900_65_4,INVERSION,1260,1656,43,396,TRANSLOCATION,1260,0,2.00528883934021
1900_70_0,INVERSION,1075,1224,37,149,INVERSION,1046,1104,1.8562994003295898
1900_70_1,INVERSION,546,978,42,432,INVERSION,546,1044,2.08697247505188
1900_70_2,INVERSION,537,1048,39,511,TRANSLOCATION,436,0,1.9570677280426025
1900_70_3,INVERSION,1292,1576,45,284,TRANSLOCATION,1292,0,2.2109413146972656
1900_70_4,INVERSION,1164,1682,43,518,TRANSLOCATION,1144,0,2.124091625213623
1900_75_0,INVERSION,414,659,34,245,INVERSION,360,744,1.7771868705749512
1900_75_1,INVERSION,919,1163,40,244,INVERSION,919,972,2.108351469039917
1900_75_2,INVERSION,450,748,39,298,TRANSLOCATION,350,0,2.0752429962158203
1900_75_3,INVERSION,977,1513,34,536,TRANSLOCATION,977,0,1.763979196548462
1900_75_4,INVERSION,1336,1774,36,438,TRANSLOCATION,1284,0,1.8662991523742676
